States,Year,CAUSE,Male,Female,Total,Lat,Long
ANDHRA PRADESH,2001,Truck/Lorry (Government),103,26,129,14.7504291,78.57002559
ANDHRA PRADESH,2001,Truck/Lorry (Private),2171,414,2585,14.7504291,78.57002559
ANDHRA PRADESH,2001,Bus (Government),488,119,607,14.7504291,78.57002559
ANDHRA PRADESH,2001,Bus (Private),289,76,365,14.7504291,78.57002559
ANDHRA PRADESH,2001,Tempo/Vans (Government),13,3,16,14.7504291,78.57002559
ANDHRA PRADESH,2001,Tempo/Vans (Private),310,70,380,14.7504291,78.57002559
ANDHRA PRADESH,2001,Jeep (Government),31,9,40,14.7504291,78.57002559
ANDHRA PRADESH,2001,Jeep (Private),473,111,584,14.7504291,78.57002559
ANDHRA PRADESH,2001,Car (Government),18,0,18,14.7504291,78.57002559
ANDHRA PRADESH,2001,Car (Private),426,125,551,14.7504291,78.57002559
ANDHRA PRADESH,2001,Three Wheeler,473,138,611,14.7504291,78.57002559
ANDHRA PRADESH,2001,Two Wheeler,775,94,869,14.7504291,78.57002559
ANDHRA PRADESH,2001,Bicycle,169,12,181,14.7504291,78.57002559
ANDHRA PRADESH,2001,Pedestrian,307,67,374,14.7504291,78.57002559
ANDHRA PRADESH,2001,Others (Please Specify),901,163,1064,14.7504291,78.57002559
ANDHRA PRADESH,2002,Truck/Lorry (Government),42,8,50,14.7504291,78.57002559
ANDHRA PRADESH,2002,Truck/Lorry (Private),2664,425,3089,14.7504291,78.57002559
ANDHRA PRADESH,2002,Bus (Government),595,146,741,14.7504291,78.57002559
ANDHRA PRADESH,2002,Bus (Private),294,67,361,14.7504291,78.57002559
ANDHRA PRADESH,2002,Tempo/Vans (Government),35,11,46,14.7504291,78.57002559
ANDHRA PRADESH,2002,Tempo/Vans (Private),413,58,471,14.7504291,78.57002559
ANDHRA PRADESH,2002,Jeep (Government),34,1,35,14.7504291,78.57002559
ANDHRA PRADESH,2002,Jeep (Private),416,97,513,14.7504291,78.57002559
ANDHRA PRADESH,2002,Car (Government),23,4,27,14.7504291,78.57002559
ANDHRA PRADESH,2002,Car (Private),341,101,442,14.7504291,78.57002559
ANDHRA PRADESH,2002,Three Wheeler,724,188,912,14.7504291,78.57002559
ANDHRA PRADESH,2002,Two Wheeler,871,138,1009,14.7504291,78.57002559
ANDHRA PRADESH,2002,Bicycle,160,15,175,14.7504291,78.57002559
ANDHRA PRADESH,2002,Pedestrian,493,90,583,14.7504291,78.57002559
ANDHRA PRADESH,2002,Others (Please Specify),729,168,897,14.7504291,78.57002559
ANDHRA PRADESH,2003,Truck/Lorry (Government),14,1,15,14.7504291,78.57002559
ANDHRA PRADESH,2003,Truck/Lorry (Private),2542,476,3018,14.7504291,78.57002559
ANDHRA PRADESH,2003,Bus (Government),468,169,637,14.7504291,78.57002559
ANDHRA PRADESH,2003,Bus (Private),376,92,468,14.7504291,78.57002559
ANDHRA PRADESH,2003,Tempo/Vans (Government),6,0,6,14.7504291,78.57002559
ANDHRA PRADESH,2003,Tempo/Vans (Private),334,81,415,14.7504291,78.57002559
ANDHRA PRADESH,2003,Jeep (Government),23,7,30,14.7504291,78.57002559
ANDHRA PRADESH,2003,Jeep (Private),536,165,701,14.7504291,78.57002559
ANDHRA PRADESH,2003,Car (Government),10,1,11,14.7504291,78.57002559
ANDHRA PRADESH,2003,Car (Private),487,147,634,14.7504291,78.57002559
ANDHRA PRADESH,2003,Three Wheeler,727,240,967,14.7504291,78.57002559
ANDHRA PRADESH,2003,Two Wheeler,1139,212,1351,14.7504291,78.57002559
ANDHRA PRADESH,2003,Bicycle,156,12,168,14.7504291,78.57002559
ANDHRA PRADESH,2003,Pedestrian,455,140,595,14.7504291,78.57002559
ANDHRA PRADESH,2003,Others (Please Specify),888,264,1152,14.7504291,78.57002559
ANDHRA PRADESH,2004,Truck/Lorry (Government),15,3,18,14.7504291,78.57002559
ANDHRA PRADESH,2004,Truck/Lorry (Private),2687,448,3135,14.7504291,78.57002559
ANDHRA PRADESH,2004,Bus (Government),597,116,713,14.7504291,78.57002559
ANDHRA PRADESH,2004,Bus (Private),253,52,305,14.7504291,78.57002559
ANDHRA PRADESH,2004,Tempo/Vans (Government),21,4,25,14.7504291,78.57002559
ANDHRA PRADESH,2004,Tempo/Vans (Private),500,100,600,14.7504291,78.57002559
ANDHRA PRADESH,2004,Jeep (Government),31,8,39,14.7504291,78.57002559
ANDHRA PRADESH,2004,Jeep (Private),547,121,668,14.7504291,78.57002559
ANDHRA PRADESH,2004,Car (Government),11,5,16,14.7504291,78.57002559
ANDHRA PRADESH,2004,Car (Private),441,119,560,14.7504291,78.57002559
ANDHRA PRADESH,2004,Three Wheeler,1250,280,1530,14.7504291,78.57002559
ANDHRA PRADESH,2004,Two Wheeler,1370,168,1538,14.7504291,78.57002559
ANDHRA PRADESH,2004,Bicycle,130,10,140,14.7504291,78.57002559
ANDHRA PRADESH,2004,Pedestrian,317,80,397,14.7504291,78.57002559
ANDHRA PRADESH,2004,Others (Please Specify),1097,179,1276,14.7504291,78.57002559
ANDHRA PRADESH,2005,Truck/Lorry (Government),35,11,46,14.7504291,78.57002559
ANDHRA PRADESH,2005,Truck/Lorry (Private),2568,594,3162,14.7504291,78.57002559
ANDHRA PRADESH,2005,Bus (Government),536,126,662,14.7504291,78.57002559
ANDHRA PRADESH,2005,Bus (Private),277,101,378,14.7504291,78.57002559
ANDHRA PRADESH,2005,Tempo/Vans (Government),6,1,7,14.7504291,78.57002559
ANDHRA PRADESH,2005,Tempo/Vans (Private),410,96,506,14.7504291,78.57002559
ANDHRA PRADESH,2005,Jeep (Government),73,6,79,14.7504291,78.57002559
ANDHRA PRADESH,2005,Jeep (Private),435,101,536,14.7504291,78.57002559
ANDHRA PRADESH,2005,Car (Government),5,0,5,14.7504291,78.57002559
ANDHRA PRADESH,2005,Car (Private),465,113,578,14.7504291,78.57002559
ANDHRA PRADESH,2005,Three Wheeler,1042,320,1362,14.7504291,78.57002559
ANDHRA PRADESH,2005,Two Wheeler,1184,203,1387,14.7504291,78.57002559
ANDHRA PRADESH,2005,Bicycle,178,9,187,14.7504291,78.57002559
ANDHRA PRADESH,2005,Pedestrian,470,107,577,14.7504291,78.57002559
ANDHRA PRADESH,2005,Others (Please Specify),1196,276,1472,14.7504291,78.57002559
ANDHRA PRADESH,2006,Truck/Lorry (Government),48,17,65,14.7504291,78.57002559
ANDHRA PRADESH,2006,Truck/Lorry (Private),2765,481,3246,14.7504291,78.57002559
ANDHRA PRADESH,2006,Bus (Government),598,152,750,14.7504291,78.57002559
ANDHRA PRADESH,2006,Bus (Private),428,131,559,14.7504291,78.57002559
ANDHRA PRADESH,2006,Tempo/Vans (Government),10,3,13,14.7504291,78.57002559
ANDHRA PRADESH,2006,Tempo/Vans (Private),380,99,479,14.7504291,78.57002559
ANDHRA PRADESH,2006,Jeep (Government),17,5,22,14.7504291,78.57002559
ANDHRA PRADESH,2006,Jeep (Private),454,131,585,14.7504291,78.57002559
ANDHRA PRADESH,2006,Car (Government),4,1,5,14.7504291,78.57002559
ANDHRA PRADESH,2006,Car (Private),638,120,758,14.7504291,78.57002559
ANDHRA PRADESH,2006,Three Wheeler,1439,399,1838,14.7504291,78.57002559
ANDHRA PRADESH,2006,Two Wheeler,1591,299,1890,14.7504291,78.57002559
ANDHRA PRADESH,2006,Bicycle,161,19,180,14.7504291,78.57002559
ANDHRA PRADESH,2006,Pedestrian,514,162,676,14.7504291,78.57002559
ANDHRA PRADESH,2006,Others (Please Specify),1339,256,1595,14.7504291,78.57002559
ANDHRA PRADESH,2007,Truck/Lorry (Government),139,9,148,14.7504291,78.57002559
ANDHRA PRADESH,2007,Truck/Lorry (Private),2610,558,3168,14.7504291,78.57002559
ANDHRA PRADESH,2007,Bus (Government),678,145,823,14.7504291,78.57002559
ANDHRA PRADESH,2007,Bus (Private),359,96,455,14.7504291,78.57002559
ANDHRA PRADESH,2007,Tempo/Vans (Government),11,4,15,14.7504291,78.57002559
ANDHRA PRADESH,2007,Tempo/Vans (Private),412,78,490,14.7504291,78.57002559
ANDHRA PRADESH,2007,Jeep (Government),17,10,27,14.7504291,78.57002559
ANDHRA PRADESH,2007,Jeep (Private),513,116,629,14.7504291,78.57002559
ANDHRA PRADESH,2007,Car (Government),6,3,9,14.7504291,78.57002559
ANDHRA PRADESH,2007,Car (Private),734,142,876,14.7504291,78.57002559
ANDHRA PRADESH,2007,Three Wheeler,1708,346,2054,14.7504291,78.57002559
ANDHRA PRADESH,2007,Two Wheeler,1859,361,2220,14.7504291,78.57002559
ANDHRA PRADESH,2007,Bicycle,298,48,346,14.7504291,78.57002559
ANDHRA PRADESH,2007,Pedestrian,675,189,864,14.7504291,78.57002559
ANDHRA PRADESH,2007,Others (Please Specify),1385,253,1638,14.7504291,78.57002559
ANDHRA PRADESH,2008,Truck/Lorry (Government),38,4,42,14.7504291,78.57002559
ANDHRA PRADESH,2008,Truck/Lorry (Private),2792,531,3323,14.7504291,78.57002559
ANDHRA PRADESH,2008,Bus (Government),598,149,747,14.7504291,78.57002559
ANDHRA PRADESH,2008,Bus (Private),446,157,603,14.7504291,78.57002559
ANDHRA PRADESH,2008,Tempo/Vans (Government),20,4,24,14.7504291,78.57002559
ANDHRA PRADESH,2008,Tempo/Vans (Private),506,99,605,14.7504291,78.57002559
ANDHRA PRADESH,2008,Jeep (Government),14,5,19,14.7504291,78.57002559
ANDHRA PRADESH,2008,Jeep (Private),567,189,756,14.7504291,78.57002559
ANDHRA PRADESH,2008,Car (Government),7,2,9,14.7504291,78.57002559
ANDHRA PRADESH,2008,Car (Private),866,227,1093,14.7504291,78.57002559
ANDHRA PRADESH,2008,Three Wheeler,1523,379,1902,14.7504291,78.57002559
ANDHRA PRADESH,2008,Two Wheeler,1888,259,2147,14.7504291,78.57002559
ANDHRA PRADESH,2008,Bicycle,240,27,267,14.7504291,78.57002559
ANDHRA PRADESH,2008,Pedestrian,622,120,742,14.7504291,78.57002559
ANDHRA PRADESH,2008,Others (Please Specify),1657,222,1879,14.7504291,78.57002559
ANDHRA PRADESH,2009,Truck/Lorry (Government),19,12,31,14.7504291,78.57002559
ANDHRA PRADESH,2009,Truck/Lorry (Private),2585,504,3089,14.7504291,78.57002559
ANDHRA PRADESH,2009,Bus (Government),447,140,587,14.7504291,78.57002559
ANDHRA PRADESH,2009,Bus (Private),585,180,765,14.7504291,78.57002559
ANDHRA PRADESH,2009,Tempo/Vans (Government),112,48,160,14.7504291,78.57002559
ANDHRA PRADESH,2009,Tempo/Vans (Private),701,144,845,14.7504291,78.57002559
ANDHRA PRADESH,2009,Jeep (Government),9,1,10,14.7504291,78.57002559
ANDHRA PRADESH,2009,Jeep (Private),456,102,558,14.7504291,78.57002559
ANDHRA PRADESH,2009,Car (Government),10,0,10,14.7504291,78.57002559
ANDHRA PRADESH,2009,Car (Private),741,151,892,14.7504291,78.57002559
ANDHRA PRADESH,2009,Three Wheeler,1637,373,2010,14.7504291,78.57002559
ANDHRA PRADESH,2009,Two Wheeler,1878,309,2187,14.7504291,78.57002559
ANDHRA PRADESH,2009,Bicycle,165,6,171,14.7504291,78.57002559
ANDHRA PRADESH,2009,Pedestrian,394,114,508,14.7504291,78.57002559
ANDHRA PRADESH,2009,Others (Please Specify),2327,366,2693,14.7504291,78.57002559
ANDHRA PRADESH,2010,Truck/Lorry (Government),58,18,76,14.7504291,78.57002559
ANDHRA PRADESH,2010,Truck/Lorry (Private),2937,440,3377,14.7504291,78.57002559
ANDHRA PRADESH,2010,Bus (Government),741,146,887,14.7504291,78.57002559
ANDHRA PRADESH,2010,Bus (Private),501,152,653,14.7504291,78.57002559
ANDHRA PRADESH,2010,Tempo/Vans (Government),7,1,8,14.7504291,78.57002559
ANDHRA PRADESH,2010,Tempo/Vans (Private),740,120,860,14.7504291,78.57002559
ANDHRA PRADESH,2010,Jeep (Government),23,5,28,14.7504291,78.57002559
ANDHRA PRADESH,2010,Jeep (Private),643,191,834,14.7504291,78.57002559
ANDHRA PRADESH,2010,Car (Government),50,6,56,14.7504291,78.57002559
ANDHRA PRADESH,2010,Car (Private),995,218,1213,14.7504291,78.57002559
ANDHRA PRADESH,2010,Three Wheeler,1882,383,2265,14.7504291,78.57002559
ANDHRA PRADESH,2010,Two Wheeler,2222,357,2579,14.7504291,78.57002559
ANDHRA PRADESH,2010,Bicycle,183,12,195,14.7504291,78.57002559
ANDHRA PRADESH,2010,Pedestrian,422,97,519,14.7504291,78.57002559
ANDHRA PRADESH,2010,Others (Please Specify),1487,300,1787,14.7504291,78.57002559
ANDHRA PRADESH,2011,Truck/Lorry (Government),18,3,21,14.7504291,78.57002559
ANDHRA PRADESH,2011,Truck/Lorry (Private),3110,471,3581,14.7504291,78.57002559
ANDHRA PRADESH,2011,Bus (Government),577,127,704,14.7504291,78.57002559
ANDHRA PRADESH,2011,Bus (Private),376,114,490,14.7504291,78.57002559
ANDHRA PRADESH,2011,Tempo/Vans (Government),85,1,86,14.7504291,78.57002559
ANDHRA PRADESH,2011,Tempo/Vans (Private),752,159,911,14.7504291,78.57002559
ANDHRA PRADESH,2011,Jeep (Government),13,3,16,14.7504291,78.57002559
ANDHRA PRADESH,2011,Jeep (Private),627,198,825,14.7504291,78.57002559
ANDHRA PRADESH,2011,Car (Government),10,4,14,14.7504291,78.57002559
ANDHRA PRADESH,2011,Car (Private),907,238,1145,14.7504291,78.57002559
ANDHRA PRADESH,2011,Three Wheeler,1485,397,1882,14.7504291,78.57002559
ANDHRA PRADESH,2011,Two Wheeler,2489,482,2971,14.7504291,78.57002559
ANDHRA PRADESH,2011,Bicycle,131,6,137,14.7504291,78.57002559
ANDHRA PRADESH,2011,Pedestrian,422,101,523,14.7504291,78.57002559
ANDHRA PRADESH,2011,Others (Please Specify),1526,326,1852,14.7504291,78.57002559
ANDHRA PRADESH,2012,Truck/Lorry (Government),26,7,33,14.7504291,78.57002559
ANDHRA PRADESH,2012,Truck/Lorry (Private),2999,400,3399,14.7504291,78.57002559
ANDHRA PRADESH,2012,Bus (Government),689,142,831,14.7504291,78.57002559
ANDHRA PRADESH,2012,Bus (Private),447,96,543,14.7504291,78.57002559
ANDHRA PRADESH,2012,Tempo/Vans (Government),19,3,22,14.7504291,78.57002559
ANDHRA PRADESH,2012,Tempo/Vans (Private),575,106,681,14.7504291,78.57002559
ANDHRA PRADESH,2012,Jeep (Government),4,0,4,14.7504291,78.57002559
ANDHRA PRADESH,2012,Jeep (Private),475,138,613,14.7504291,78.57002559
ANDHRA PRADESH,2012,Car (Government),35,3,38,14.7504291,78.57002559
ANDHRA PRADESH,2012,Car (Private),1125,175,1300,14.7504291,78.57002559
ANDHRA PRADESH,2012,Three Wheeler,1333,401,1734,14.7504291,78.57002559
ANDHRA PRADESH,2012,Two Wheeler,2357,344,2701,14.7504291,78.57002559
ANDHRA PRADESH,2012,Bicycle,173,8,181,14.7504291,78.57002559
ANDHRA PRADESH,2012,Pedestrian,590,105,695,14.7504291,78.57002559
ANDHRA PRADESH,2012,Others (Please Specify),1896,295,2191,14.7504291,78.57002559
ARUNACHAL PRADESH,2001,Truck/Lorry (Government),2,0,2,27.10039878,93.61660071
ARUNACHAL PRADESH,2001,Truck/Lorry (Private),27,6,33,27.10039878,93.61660071
ARUNACHAL PRADESH,2001,Bus (Government),0,0,0,27.10039878,93.61660071
ARUNACHAL PRADESH,2001,Bus (Private),8,0,8,27.10039878,93.61660071
ARUNACHAL PRADESH,2001,Tempo/Vans (Government),0,4,4,27.10039878,93.61660071
ARUNACHAL PRADESH,2001,Tempo/Vans (Private),0,0,0,27.10039878,93.61660071
ARUNACHAL PRADESH,2001,Jeep (Government),0,0,0,27.10039878,93.61660071
ARUNACHAL PRADESH,2001,Jeep (Private),4,0,4,27.10039878,93.61660071
ARUNACHAL PRADESH,2001,Car (Government),0,0,0,27.10039878,93.61660071
ARUNACHAL PRADESH,2001,Car (Private),0,0,0,27.10039878,93.61660071
ARUNACHAL PRADESH,2001,Three Wheeler,0,0,0,27.10039878,93.61660071
ARUNACHAL PRADESH,2001,Two Wheeler,7,1,8,27.10039878,93.61660071
ARUNACHAL PRADESH,2001,Bicycle,0,0,0,27.10039878,93.61660071
ARUNACHAL PRADESH,2001,Pedestrian,1,0,1,27.10039878,93.61660071
ARUNACHAL PRADESH,2001,Others (Please Specify),0,0,0,27.10039878,93.61660071
ARUNACHAL PRADESH,2002,Truck/Lorry (Government),2,1,3,27.10039878,93.61660071
ARUNACHAL PRADESH,2002,Truck/Lorry (Private),59,12,71,27.10039878,93.61660071
ARUNACHAL PRADESH,2002,Bus (Government),2,1,3,27.10039878,93.61660071
ARUNACHAL PRADESH,2002,Bus (Private),2,1,3,27.10039878,93.61660071
ARUNACHAL PRADESH,2002,Tempo/Vans (Government),0,0,0,27.10039878,93.61660071
ARUNACHAL PRADESH,2002,Tempo/Vans (Private),2,0,2,27.10039878,93.61660071
ARUNACHAL PRADESH,2002,Jeep (Government),1,1,2,27.10039878,93.61660071
ARUNACHAL PRADESH,2002,Jeep (Private),11,2,13,27.10039878,93.61660071
ARUNACHAL PRADESH,2002,Car (Government),0,0,0,27.10039878,93.61660071
ARUNACHAL PRADESH,2002,Car (Private),0,0,0,27.10039878,93.61660071
ARUNACHAL PRADESH,2002,Three Wheeler,1,0,1,27.10039878,93.61660071
ARUNACHAL PRADESH,2002,Two Wheeler,14,2,16,27.10039878,93.61660071
ARUNACHAL PRADESH,2002,Bicycle,0,0,0,27.10039878,93.61660071
ARUNACHAL PRADESH,2002,Pedestrian,0,0,0,27.10039878,93.61660071
ARUNACHAL PRADESH,2002,Others (Please Specify),0,0,0,27.10039878,93.61660071
ARUNACHAL PRADESH,2003,Truck/Lorry (Government),7,2,9,27.10039878,93.61660071
ARUNACHAL PRADESH,2003,Truck/Lorry (Private),40,6,46,27.10039878,93.61660071
ARUNACHAL PRADESH,2003,Bus (Government),8,11,19,27.10039878,93.61660071
ARUNACHAL PRADESH,2003,Bus (Private),23,2,25,27.10039878,93.61660071
ARUNACHAL PRADESH,2003,Tempo/Vans (Government),0,0,0,27.10039878,93.61660071
ARUNACHAL PRADESH,2003,Tempo/Vans (Private),3,0,3,27.10039878,93.61660071
ARUNACHAL PRADESH,2003,Jeep (Government),0,0,0,27.10039878,93.61660071
ARUNACHAL PRADESH,2003,Jeep (Private),13,2,15,27.10039878,93.61660071
ARUNACHAL PRADESH,2003,Car (Government),0,0,0,27.10039878,93.61660071
ARUNACHAL PRADESH,2003,Car (Private),0,0,0,27.10039878,93.61660071
ARUNACHAL PRADESH,2003,Three Wheeler,5,0,5,27.10039878,93.61660071
ARUNACHAL PRADESH,2003,Two Wheeler,11,1,12,27.10039878,93.61660071
ARUNACHAL PRADESH,2003,Bicycle,1,0,1,27.10039878,93.61660071
ARUNACHAL PRADESH,2003,Pedestrian,0,0,0,27.10039878,93.61660071
ARUNACHAL PRADESH,2003,Others (Please Specify),0,0,0,27.10039878,93.61660071
ARUNACHAL PRADESH,2004,Truck/Lorry (Government),12,0,12,27.10039878,93.61660071
ARUNACHAL PRADESH,2004,Truck/Lorry (Private),36,3,39,27.10039878,93.61660071
ARUNACHAL PRADESH,2004,Bus (Government),0,0,0,27.10039878,93.61660071
ARUNACHAL PRADESH,2004,Bus (Private),55,22,77,27.10039878,93.61660071
ARUNACHAL PRADESH,2004,Tempo/Vans (Government),0,0,0,27.10039878,93.61660071
ARUNACHAL PRADESH,2004,Tempo/Vans (Private),7,0,7,27.10039878,93.61660071
ARUNACHAL PRADESH,2004,Jeep (Government),0,0,0,27.10039878,93.61660071
ARUNACHAL PRADESH,2004,Jeep (Private),3,2,5,27.10039878,93.61660071
ARUNACHAL PRADESH,2004,Car (Government),0,0,0,27.10039878,93.61660071
ARUNACHAL PRADESH,2004,Car (Private),4,1,5,27.10039878,93.61660071
ARUNACHAL PRADESH,2004,Three Wheeler,6,0,6,27.10039878,93.61660071
ARUNACHAL PRADESH,2004,Two Wheeler,18,5,23,27.10039878,93.61660071
ARUNACHAL PRADESH,2004,Bicycle,1,0,1,27.10039878,93.61660071
ARUNACHAL PRADESH,2004,Pedestrian,5,1,6,27.10039878,93.61660071
ARUNACHAL PRADESH,2004,Others (Please Specify),0,0,0,27.10039878,93.61660071
ARUNACHAL PRADESH,2005,Truck/Lorry (Government),11,1,12,27.10039878,93.61660071
ARUNACHAL PRADESH,2005,Truck/Lorry (Private),33,2,35,27.10039878,93.61660071
ARUNACHAL PRADESH,2005,Bus (Government),0,1,1,27.10039878,93.61660071
ARUNACHAL PRADESH,2005,Bus (Private),4,1,5,27.10039878,93.61660071
ARUNACHAL PRADESH,2005,Tempo/Vans (Government),0,0,0,27.10039878,93.61660071
ARUNACHAL PRADESH,2005,Tempo/Vans (Private),7,2,9,27.10039878,93.61660071
ARUNACHAL PRADESH,2005,Jeep (Government),2,0,2,27.10039878,93.61660071
ARUNACHAL PRADESH,2005,Jeep (Private),6,1,7,27.10039878,93.61660071
ARUNACHAL PRADESH,2005,Car (Government),0,0,0,27.10039878,93.61660071
ARUNACHAL PRADESH,2005,Car (Private),2,0,2,27.10039878,93.61660071
ARUNACHAL PRADESH,2005,Three Wheeler,2,1,3,27.10039878,93.61660071
ARUNACHAL PRADESH,2005,Two Wheeler,11,0,11,27.10039878,93.61660071
ARUNACHAL PRADESH,2005,Bicycle,0,0,0,27.10039878,93.61660071
ARUNACHAL PRADESH,2005,Pedestrian,1,1,2,27.10039878,93.61660071
ARUNACHAL PRADESH,2005,Others (Please Specify),0,0,0,27.10039878,93.61660071
ARUNACHAL PRADESH,2006,Truck/Lorry (Government),21,2,23,27.10039878,93.61660071
ARUNACHAL PRADESH,2006,Truck/Lorry (Private),23,1,24,27.10039878,93.61660071
ARUNACHAL PRADESH,2006,Bus (Government),0,0,0,27.10039878,93.61660071
ARUNACHAL PRADESH,2006,Bus (Private),4,1,5,27.10039878,93.61660071
ARUNACHAL PRADESH,2006,Tempo/Vans (Government),3,0,3,27.10039878,93.61660071
ARUNACHAL PRADESH,2006,Tempo/Vans (Private),0,0,0,27.10039878,93.61660071
ARUNACHAL PRADESH,2006,Jeep (Government),6,1,7,27.10039878,93.61660071
ARUNACHAL PRADESH,2006,Jeep (Private),11,0,11,27.10039878,93.61660071
ARUNACHAL PRADESH,2006,Car (Government),2,1,3,27.10039878,93.61660071
ARUNACHAL PRADESH,2006,Car (Private),1,0,1,27.10039878,93.61660071
ARUNACHAL PRADESH,2006,Three Wheeler,0,0,0,27.10039878,93.61660071
ARUNACHAL PRADESH,2006,Two Wheeler,38,0,38,27.10039878,93.61660071
ARUNACHAL PRADESH,2006,Bicycle,0,0,0,27.10039878,93.61660071
ARUNACHAL PRADESH,2006,Pedestrian,0,0,0,27.10039878,93.61660071
ARUNACHAL PRADESH,2006,Others (Please Specify),1,0,1,27.10039878,93.61660071
ARUNACHAL PRADESH,2007,Truck/Lorry (Government),12,2,14,27.10039878,93.61660071
ARUNACHAL PRADESH,2007,Truck/Lorry (Private),27,4,31,27.10039878,93.61660071
ARUNACHAL PRADESH,2007,Bus (Government),1,1,2,27.10039878,93.61660071
ARUNACHAL PRADESH,2007,Bus (Private),4,0,4,27.10039878,93.61660071
ARUNACHAL PRADESH,2007,Tempo/Vans (Government),0,0,0,27.10039878,93.61660071
ARUNACHAL PRADESH,2007,Tempo/Vans (Private),0,0,0,27.10039878,93.61660071
ARUNACHAL PRADESH,2007,Jeep (Government),5,2,7,27.10039878,93.61660071
ARUNACHAL PRADESH,2007,Jeep (Private),6,1,7,27.10039878,93.61660071
ARUNACHAL PRADESH,2007,Car (Government),0,0,0,27.10039878,93.61660071
ARUNACHAL PRADESH,2007,Car (Private),15,0,15,27.10039878,93.61660071
ARUNACHAL PRADESH,2007,Three Wheeler,2,0,2,27.10039878,93.61660071
ARUNACHAL PRADESH,2007,Two Wheeler,16,4,20,27.10039878,93.61660071
ARUNACHAL PRADESH,2007,Bicycle,1,0,1,27.10039878,93.61660071
ARUNACHAL PRADESH,2007,Pedestrian,0,0,0,27.10039878,93.61660071
ARUNACHAL PRADESH,2007,Others (Please Specify),5,0,5,27.10039878,93.61660071
ARUNACHAL PRADESH,2008,Truck/Lorry (Government),3,0,3,27.10039878,93.61660071
ARUNACHAL PRADESH,2008,Truck/Lorry (Private),49,2,51,27.10039878,93.61660071
ARUNACHAL PRADESH,2008,Bus (Government),7,1,8,27.10039878,93.61660071
ARUNACHAL PRADESH,2008,Bus (Private),6,1,7,27.10039878,93.61660071
ARUNACHAL PRADESH,2008,Tempo/Vans (Government),0,0,0,27.10039878,93.61660071
ARUNACHAL PRADESH,2008,Tempo/Vans (Private),0,0,0,27.10039878,93.61660071
ARUNACHAL PRADESH,2008,Jeep (Government),1,1,2,27.10039878,93.61660071
ARUNACHAL PRADESH,2008,Jeep (Private),9,8,17,27.10039878,93.61660071
ARUNACHAL PRADESH,2008,Car (Government),0,0,0,27.10039878,93.61660071
ARUNACHAL PRADESH,2008,Car (Private),3,4,7,27.10039878,93.61660071
ARUNACHAL PRADESH,2008,Three Wheeler,1,3,4,27.10039878,93.61660071
ARUNACHAL PRADESH,2008,Two Wheeler,20,1,21,27.10039878,93.61660071
ARUNACHAL PRADESH,2008,Bicycle,0,0,0,27.10039878,93.61660071
ARUNACHAL PRADESH,2008,Pedestrian,3,2,5,27.10039878,93.61660071
ARUNACHAL PRADESH,2008,Others (Please Specify),0,0,0,27.10039878,93.61660071
ARUNACHAL PRADESH,2009,Truck/Lorry (Government),3,0,3,27.10039878,93.61660071
ARUNACHAL PRADESH,2009,Truck/Lorry (Private),49,2,51,27.10039878,93.61660071
ARUNACHAL PRADESH,2009,Bus (Government),7,1,8,27.10039878,93.61660071
ARUNACHAL PRADESH,2009,Bus (Private),6,1,7,27.10039878,93.61660071
ARUNACHAL PRADESH,2009,Tempo/Vans (Government),0,0,0,27.10039878,93.61660071
ARUNACHAL PRADESH,2009,Tempo/Vans (Private),0,0,0,27.10039878,93.61660071
ARUNACHAL PRADESH,2009,Jeep (Government),1,1,2,27.10039878,93.61660071
ARUNACHAL PRADESH,2009,Jeep (Private),9,8,17,27.10039878,93.61660071
ARUNACHAL PRADESH,2009,Car (Government),0,0,0,27.10039878,93.61660071
ARUNACHAL PRADESH,2009,Car (Private),3,4,7,27.10039878,93.61660071
ARUNACHAL PRADESH,2009,Three Wheeler,1,3,4,27.10039878,93.61660071
ARUNACHAL PRADESH,2009,Two Wheeler,20,1,21,27.10039878,93.61660071
ARUNACHAL PRADESH,2009,Bicycle,0,0,0,27.10039878,93.61660071
ARUNACHAL PRADESH,2009,Pedestrian,3,2,5,27.10039878,93.61660071
ARUNACHAL PRADESH,2009,Others (Please Specify),0,0,0,27.10039878,93.61660071
ARUNACHAL PRADESH,2010,Truck/Lorry (Government),16,1,17,27.10039878,93.61660071
ARUNACHAL PRADESH,2010,Truck/Lorry (Private),36,4,40,27.10039878,93.61660071
ARUNACHAL PRADESH,2010,Bus (Government),3,0,3,27.10039878,93.61660071
ARUNACHAL PRADESH,2010,Bus (Private),2,0,2,27.10039878,93.61660071
ARUNACHAL PRADESH,2010,Tempo/Vans (Government),1,0,1,27.10039878,93.61660071
ARUNACHAL PRADESH,2010,Tempo/Vans (Private),1,0,1,27.10039878,93.61660071
ARUNACHAL PRADESH,2010,Jeep (Government),0,0,0,27.10039878,93.61660071
ARUNACHAL PRADESH,2010,Jeep (Private),6,3,9,27.10039878,93.61660071
ARUNACHAL PRADESH,2010,Car (Government),1,0,1,27.10039878,93.61660071
ARUNACHAL PRADESH,2010,Car (Private),9,1,10,27.10039878,93.61660071
ARUNACHAL PRADESH,2010,Three Wheeler,4,2,6,27.10039878,93.61660071
ARUNACHAL PRADESH,2010,Two Wheeler,28,6,34,27.10039878,93.61660071
ARUNACHAL PRADESH,2010,Bicycle,1,0,1,27.10039878,93.61660071
ARUNACHAL PRADESH,2010,Pedestrian,3,1,4,27.10039878,93.61660071
ARUNACHAL PRADESH,2010,Others (Please Specify),9,1,10,27.10039878,93.61660071
ARUNACHAL PRADESH,2011,Truck/Lorry (Government),5,0,5,27.10039878,93.61660071
ARUNACHAL PRADESH,2011,Truck/Lorry (Private),26,5,31,27.10039878,93.61660071
ARUNACHAL PRADESH,2011,Bus (Government),1,1,2,27.10039878,93.61660071
ARUNACHAL PRADESH,2011,Bus (Private),3,1,4,27.10039878,93.61660071
ARUNACHAL PRADESH,2011,Tempo/Vans (Government),0,0,0,27.10039878,93.61660071
ARUNACHAL PRADESH,2011,Tempo/Vans (Private),4,0,4,27.10039878,93.61660071
ARUNACHAL PRADESH,2011,Jeep (Government),5,0,5,27.10039878,93.61660071
ARUNACHAL PRADESH,2011,Jeep (Private),1,3,4,27.10039878,93.61660071
ARUNACHAL PRADESH,2011,Car (Government),3,0,3,27.10039878,93.61660071
ARUNACHAL PRADESH,2011,Car (Private),19,5,24,27.10039878,93.61660071
ARUNACHAL PRADESH,2011,Three Wheeler,1,0,1,27.10039878,93.61660071
ARUNACHAL PRADESH,2011,Two Wheeler,31,9,40,27.10039878,93.61660071
ARUNACHAL PRADESH,2011,Bicycle,0,0,0,27.10039878,93.61660071
ARUNACHAL PRADESH,2011,Pedestrian,0,0,0,27.10039878,93.61660071
ARUNACHAL PRADESH,2011,Others (Please Specify),3,0,3,27.10039878,93.61660071
ARUNACHAL PRADESH,2012,Truck/Lorry (Government),3,0,3,27.10039878,93.61660071
ARUNACHAL PRADESH,2012,Truck/Lorry (Private),20,6,26,27.10039878,93.61660071
ARUNACHAL PRADESH,2012,Bus (Government),2,0,2,27.10039878,93.61660071
ARUNACHAL PRADESH,2012,Bus (Private),4,0,4,27.10039878,93.61660071
ARUNACHAL PRADESH,2012,Tempo/Vans (Government),0,0,0,27.10039878,93.61660071
ARUNACHAL PRADESH,2012,Tempo/Vans (Private),3,0,3,27.10039878,93.61660071
ARUNACHAL PRADESH,2012,Jeep (Government),1,0,1,27.10039878,93.61660071
ARUNACHAL PRADESH,2012,Jeep (Private),12,3,15,27.10039878,93.61660071
ARUNACHAL PRADESH,2012,Car (Government),0,0,0,27.10039878,93.61660071
ARUNACHAL PRADESH,2012,Car (Private),11,2,13,27.10039878,93.61660071
ARUNACHAL PRADESH,2012,Three Wheeler,7,1,8,27.10039878,93.61660071
ARUNACHAL PRADESH,2012,Two Wheeler,31,10,41,27.10039878,93.61660071
ARUNACHAL PRADESH,2012,Bicycle,0,0,0,27.10039878,93.61660071
ARUNACHAL PRADESH,2012,Pedestrian,18,2,20,27.10039878,93.61660071
ARUNACHAL PRADESH,2012,Others (Please Specify),0,0,0,27.10039878,93.61660071
ASSAM,2001,Truck/Lorry (Government),2,0,2,26.7499809,94.21666744
ASSAM,2001,Truck/Lorry (Private),173,19,192,26.7499809,94.21666744
ASSAM,2001,Bus (Government),2,1,3,26.7499809,94.21666744
ASSAM,2001,Bus (Private),231,66,297,26.7499809,94.21666744
ASSAM,2001,Tempo/Vans (Government),3,0,3,26.7499809,94.21666744
ASSAM,2001,Tempo/Vans (Private),8,1,9,26.7499809,94.21666744
ASSAM,2001,Jeep (Government),1,0,1,26.7499809,94.21666744
ASSAM,2001,Jeep (Private),28,8,36,26.7499809,94.21666744
ASSAM,2001,Car (Government),6,0,6,26.7499809,94.21666744
ASSAM,2001,Car (Private),40,19,59,26.7499809,94.21666744
ASSAM,2001,Three Wheeler,8,0,8,26.7499809,94.21666744
ASSAM,2001,Two Wheeler,29,13,42,26.7499809,94.21666744
ASSAM,2001,Bicycle,27,2,29,26.7499809,94.21666744
ASSAM,2001,Pedestrian,53,18,71,26.7499809,94.21666744
ASSAM,2001,Others (Please Specify),13,5,18,26.7499809,94.21666744
ASSAM,2002,Truck/Lorry (Government),21,4,25,26.7499809,94.21666744
ASSAM,2002,Truck/Lorry (Private),204,36,240,26.7499809,94.21666744
ASSAM,2002,Bus (Government),8,4,12,26.7499809,94.21666744
ASSAM,2002,Bus (Private),220,65,285,26.7499809,94.21666744
ASSAM,2002,Tempo/Vans (Government),7,1,8,26.7499809,94.21666744
ASSAM,2002,Tempo/Vans (Private),16,1,17,26.7499809,94.21666744
ASSAM,2002,Jeep (Government),4,0,4,26.7499809,94.21666744
ASSAM,2002,Jeep (Private),27,3,30,26.7499809,94.21666744
ASSAM,2002,Car (Government),4,0,4,26.7499809,94.21666744
ASSAM,2002,Car (Private),44,14,58,26.7499809,94.21666744
ASSAM,2002,Three Wheeler,28,10,38,26.7499809,94.21666744
ASSAM,2002,Two Wheeler,43,8,51,26.7499809,94.21666744
ASSAM,2002,Bicycle,23,0,23,26.7499809,94.21666744
ASSAM,2002,Pedestrian,59,3,62,26.7499809,94.21666744
ASSAM,2002,Others (Please Specify),46,6,52,26.7499809,94.21666744
ASSAM,2003,Truck/Lorry (Government),9,4,13,26.7499809,94.21666744
ASSAM,2003,Truck/Lorry (Private),256,44,300,26.7499809,94.21666744
ASSAM,2003,Bus (Government),4,5,9,26.7499809,94.21666744
ASSAM,2003,Bus (Private),322,89,411,26.7499809,94.21666744
ASSAM,2003,Tempo/Vans (Government),7,3,10,26.7499809,94.21666744
ASSAM,2003,Tempo/Vans (Private),22,27,49,26.7499809,94.21666744
ASSAM,2003,Jeep (Government),13,10,23,26.7499809,94.21666744
ASSAM,2003,Jeep (Private),19,6,25,26.7499809,94.21666744
ASSAM,2003,Car (Government),5,1,6,26.7499809,94.21666744
ASSAM,2003,Car (Private),38,7,45,26.7499809,94.21666744
ASSAM,2003,Three Wheeler,20,13,33,26.7499809,94.21666744
ASSAM,2003,Two Wheeler,89,18,107,26.7499809,94.21666744
ASSAM,2003,Bicycle,8,0,8,26.7499809,94.21666744
ASSAM,2003,Pedestrian,60,5,65,26.7499809,94.21666744
ASSAM,2003,Others (Please Specify),26,7,33,26.7499809,94.21666744
ASSAM,2004,Truck/Lorry (Government),6,1,7,26.7499809,94.21666744
ASSAM,2004,Truck/Lorry (Private),206,16,222,26.7499809,94.21666744
ASSAM,2004,Bus (Government),10,1,11,26.7499809,94.21666744
ASSAM,2004,Bus (Private),332,76,408,26.7499809,94.21666744
ASSAM,2004,Tempo/Vans (Government),6,1,7,26.7499809,94.21666744
ASSAM,2004,Tempo/Vans (Private),23,5,28,26.7499809,94.21666744
ASSAM,2004,Jeep (Government),7,1,8,26.7499809,94.21666744
ASSAM,2004,Jeep (Private),41,7,48,26.7499809,94.21666744
ASSAM,2004,Car (Government),6,1,7,26.7499809,94.21666744
ASSAM,2004,Car (Private),54,11,65,26.7499809,94.21666744
ASSAM,2004,Three Wheeler,18,4,22,26.7499809,94.21666744
ASSAM,2004,Two Wheeler,64,15,79,26.7499809,94.21666744
ASSAM,2004,Bicycle,7,2,9,26.7499809,94.21666744
ASSAM,2004,Pedestrian,33,6,39,26.7499809,94.21666744
ASSAM,2004,Others (Please Specify),41,11,52,26.7499809,94.21666744
ASSAM,2005,Truck/Lorry (Government),0,0,0,26.7499809,94.21666744
ASSAM,2005,Truck/Lorry (Private),258,24,282,26.7499809,94.21666744
ASSAM,2005,Bus (Government),11,2,13,26.7499809,94.21666744
ASSAM,2005,Bus (Private),436,85,521,26.7499809,94.21666744
ASSAM,2005,Tempo/Vans (Government),0,0,0,26.7499809,94.21666744
ASSAM,2005,Tempo/Vans (Private),73,7,80,26.7499809,94.21666744
ASSAM,2005,Jeep (Government),0,0,0,26.7499809,94.21666744
ASSAM,2005,Jeep (Private),85,12,97,26.7499809,94.21666744
ASSAM,2005,Car (Government),1,0,1,26.7499809,94.21666744
ASSAM,2005,Car (Private),106,28,134,26.7499809,94.21666744
ASSAM,2005,Three Wheeler,52,3,55,26.7499809,94.21666744
ASSAM,2005,Two Wheeler,96,20,116,26.7499809,94.21666744
ASSAM,2005,Bicycle,22,6,28,26.7499809,94.21666744
ASSAM,2005,Pedestrian,63,9,72,26.7499809,94.21666744
ASSAM,2005,Others (Please Specify),48,9,57,26.7499809,94.21666744
ASSAM,2006,Truck/Lorry (Government),9,0,9,26.7499809,94.21666744
ASSAM,2006,Truck/Lorry (Private),289,40,329,26.7499809,94.21666744
ASSAM,2006,Bus (Government),8,0,8,26.7499809,94.21666744
ASSAM,2006,Bus (Private),459,182,641,26.7499809,94.21666744
ASSAM,2006,Tempo/Vans (Government),6,0,6,26.7499809,94.21666744
ASSAM,2006,Tempo/Vans (Private),74,19,93,26.7499809,94.21666744
ASSAM,2006,Jeep (Government),4,1,5,26.7499809,94.21666744
ASSAM,2006,Jeep (Private),67,14,81,26.7499809,94.21666744
ASSAM,2006,Car (Government),1,0,1,26.7499809,94.21666744
ASSAM,2006,Car (Private),131,35,166,26.7499809,94.21666744
ASSAM,2006,Three Wheeler,37,9,46,26.7499809,94.21666744
ASSAM,2006,Two Wheeler,164,31,195,26.7499809,94.21666744
ASSAM,2006,Bicycle,49,6,55,26.7499809,94.21666744
ASSAM,2006,Pedestrian,74,13,87,26.7499809,94.21666744
ASSAM,2006,Others (Please Specify),17,1,18,26.7499809,94.21666744
ASSAM,2007,Truck/Lorry (Government),20,2,22,26.7499809,94.21666744
ASSAM,2007,Truck/Lorry (Private),293,29,322,26.7499809,94.21666744
ASSAM,2007,Bus (Government),7,0,7,26.7499809,94.21666744
ASSAM,2007,Bus (Private),408,73,481,26.7499809,94.21666744
ASSAM,2007,Tempo/Vans (Government),8,0,8,26.7499809,94.21666744
ASSAM,2007,Tempo/Vans (Private),76,6,82,26.7499809,94.21666744
ASSAM,2007,Jeep (Government),3,0,3,26.7499809,94.21666744
ASSAM,2007,Jeep (Private),96,11,107,26.7499809,94.21666744
ASSAM,2007,Car (Government),0,0,0,26.7499809,94.21666744
ASSAM,2007,Car (Private),113,14,127,26.7499809,94.21666744
ASSAM,2007,Three Wheeler,51,6,57,26.7499809,94.21666744
ASSAM,2007,Two Wheeler,155,16,171,26.7499809,94.21666744
ASSAM,2007,Bicycle,72,4,76,26.7499809,94.21666744
ASSAM,2007,Pedestrian,92,15,107,26.7499809,94.21666744
ASSAM,2007,Others (Please Specify),25,9,34,26.7499809,94.21666744
ASSAM,2008,Truck/Lorry (Government),1,0,1,26.7499809,94.21666744
ASSAM,2008,Truck/Lorry (Private),327,33,360,26.7499809,94.21666744
ASSAM,2008,Bus (Government),7,1,8,26.7499809,94.21666744
ASSAM,2008,Bus (Private),426,102,528,26.7499809,94.21666744
ASSAM,2008,Tempo/Vans (Government),0,0,0,26.7499809,94.21666744
ASSAM,2008,Tempo/Vans (Private),68,11,79,26.7499809,94.21666744
ASSAM,2008,Jeep (Government),1,0,1,26.7499809,94.21666744
ASSAM,2008,Jeep (Private),48,7,55,26.7499809,94.21666744
ASSAM,2008,Car (Government),2,0,2,26.7499809,94.21666744
ASSAM,2008,Car (Private),93,34,127,26.7499809,94.21666744
ASSAM,2008,Three Wheeler,69,11,80,26.7499809,94.21666744
ASSAM,2008,Two Wheeler,199,37,236,26.7499809,94.21666744
ASSAM,2008,Bicycle,75,7,82,26.7499809,94.21666744
ASSAM,2008,Pedestrian,109,16,125,26.7499809,94.21666744
ASSAM,2008,Others (Please Specify),34,3,37,26.7499809,94.21666744
ASSAM,2009,Truck/Lorry (Government),4,1,5,26.7499809,94.21666744
ASSAM,2009,Truck/Lorry (Private),378,44,422,26.7499809,94.21666744
ASSAM,2009,Bus (Government),1,0,1,26.7499809,94.21666744
ASSAM,2009,Bus (Private),420,83,503,26.7499809,94.21666744
ASSAM,2009,Tempo/Vans (Government),3,2,5,26.7499809,94.21666744
ASSAM,2009,Tempo/Vans (Private),103,13,116,26.7499809,94.21666744
ASSAM,2009,Jeep (Government),1,0,1,26.7499809,94.21666744
ASSAM,2009,Jeep (Private),51,20,71,26.7499809,94.21666744
ASSAM,2009,Car (Government),18,4,22,26.7499809,94.21666744
ASSAM,2009,Car (Private),225,29,254,26.7499809,94.21666744
ASSAM,2009,Three Wheeler,73,11,84,26.7499809,94.21666744
ASSAM,2009,Two Wheeler,242,39,281,26.7499809,94.21666744
ASSAM,2009,Bicycle,39,1,40,26.7499809,94.21666744
ASSAM,2009,Pedestrian,100,17,117,26.7499809,94.21666744
ASSAM,2009,Others (Please Specify),51,10,61,26.7499809,94.21666744
ASSAM,2010,Truck/Lorry (Government),9,0,9,26.7499809,94.21666744
ASSAM,2010,Truck/Lorry (Private),352,42,394,26.7499809,94.21666744
ASSAM,2010,Bus (Government),7,0,7,26.7499809,94.21666744
ASSAM,2010,Bus (Private),312,76,388,26.7499809,94.21666744
ASSAM,2010,Tempo/Vans (Government),1,0,1,26.7499809,94.21666744
ASSAM,2010,Tempo/Vans (Private),141,26,167,26.7499809,94.21666744
ASSAM,2010,Jeep (Government),3,0,3,26.7499809,94.21666744
ASSAM,2010,Jeep (Private),51,11,62,26.7499809,94.21666744
ASSAM,2010,Car (Government),0,0,0,26.7499809,94.21666744
ASSAM,2010,Car (Private),357,80,437,26.7499809,94.21666744
ASSAM,2010,Three Wheeler,85,20,105,26.7499809,94.21666744
ASSAM,2010,Two Wheeler,246,38,284,26.7499809,94.21666744
ASSAM,2010,Bicycle,63,3,66,26.7499809,94.21666744
ASSAM,2010,Pedestrian,59,5,64,26.7499809,94.21666744
ASSAM,2010,Others (Please Specify),34,9,43,26.7499809,94.21666744
ASSAM,2011,Truck/Lorry (Government),0,0,0,26.7499809,94.21666744
ASSAM,2011,Truck/Lorry (Private),528,27,555,26.7499809,94.21666744
ASSAM,2011,Bus (Government),0,0,0,26.7499809,94.21666744
ASSAM,2011,Bus (Private),277,54,331,26.7499809,94.21666744
ASSAM,2011,Tempo/Vans (Government),0,0,0,26.7499809,94.21666744
ASSAM,2011,Tempo/Vans (Private),58,15,73,26.7499809,94.21666744
ASSAM,2011,Jeep (Government),1,0,1,26.7499809,94.21666744
ASSAM,2011,Jeep (Private),38,13,51,26.7499809,94.21666744
ASSAM,2011,Car (Government),0,0,0,26.7499809,94.21666744
ASSAM,2011,Car (Private),491,86,577,26.7499809,94.21666744
ASSAM,2011,Three Wheeler,62,8,70,26.7499809,94.21666744
ASSAM,2011,Two Wheeler,345,41,386,26.7499809,94.21666744
ASSAM,2011,Bicycle,38,2,40,26.7499809,94.21666744
ASSAM,2011,Pedestrian,53,4,57,26.7499809,94.21666744
ASSAM,2011,Others (Please Specify),173,28,201,26.7499809,94.21666744
ASSAM,2012,Truck/Lorry (Government),0,0,0,26.7499809,94.21666744
ASSAM,2012,Truck/Lorry (Private),427,28,455,26.7499809,94.21666744
ASSAM,2012,Bus (Government),1,0,1,26.7499809,94.21666744
ASSAM,2012,Bus (Private),202,57,259,26.7499809,94.21666744
ASSAM,2012,Tempo/Vans (Government),0,0,0,26.7499809,94.21666744
ASSAM,2012,Tempo/Vans (Private),74,13,87,26.7499809,94.21666744
ASSAM,2012,Jeep (Government),0,0,0,26.7499809,94.21666744
ASSAM,2012,Jeep (Private),58,6,64,26.7499809,94.21666744
ASSAM,2012,Car (Government),11,0,11,26.7499809,94.21666744
ASSAM,2012,Car (Private),343,45,388,26.7499809,94.21666744
ASSAM,2012,Three Wheeler,71,4,75,26.7499809,94.21666744
ASSAM,2012,Two Wheeler,428,42,470,26.7499809,94.21666744
ASSAM,2012,Bicycle,51,4,55,26.7499809,94.21666744
ASSAM,2012,Pedestrian,92,4,96,26.7499809,94.21666744
ASSAM,2012,Others (Please Specify),315,15,330,26.7499809,94.21666744
BIHAR,2001,Truck/Lorry (Government),15,10,25,25.78541445,87.4799727
BIHAR,2001,Truck/Lorry (Private),633,119,752,25.78541445,87.4799727
BIHAR,2001,Bus (Government),6,0,6,25.78541445,87.4799727
BIHAR,2001,Bus (Private),370,94,464,25.78541445,87.4799727
BIHAR,2001,Tempo/Vans (Government),0,0,0,25.78541445,87.4799727
BIHAR,2001,Tempo/Vans (Private),86,28,114,25.78541445,87.4799727
BIHAR,2001,Jeep (Government),6,0,6,25.78541445,87.4799727
BIHAR,2001,Jeep (Private),227,38,265,25.78541445,87.4799727
BIHAR,2001,Car (Government),0,0,0,25.78541445,87.4799727
BIHAR,2001,Car (Private),79,20,99,25.78541445,87.4799727
BIHAR,2001,Three Wheeler,23,7,30,25.78541445,87.4799727
BIHAR,2001,Two Wheeler,120,10,130,25.78541445,87.4799727
BIHAR,2001,Bicycle,18,1,19,25.78541445,87.4799727
BIHAR,2001,Pedestrian,13,4,17,25.78541445,87.4799727
BIHAR,2001,Others (Please Specify),298,45,343,25.78541445,87.4799727
BIHAR,2002,Truck/Lorry (Government),2,0,2,25.78541445,87.4799727
BIHAR,2002,Truck/Lorry (Private),485,78,563,25.78541445,87.4799727
BIHAR,2002,Bus (Government),46,6,52,25.78541445,87.4799727
BIHAR,2002,Bus (Private),314,66,380,25.78541445,87.4799727
BIHAR,2002,Tempo/Vans (Government),2,0,2,25.78541445,87.4799727
BIHAR,2002,Tempo/Vans (Private),119,35,154,25.78541445,87.4799727
BIHAR,2002,Jeep (Government),5,3,8,25.78541445,87.4799727
BIHAR,2002,Jeep (Private),256,60,316,25.78541445,87.4799727
BIHAR,2002,Car (Government),1,0,1,25.78541445,87.4799727
BIHAR,2002,Car (Private),82,15,97,25.78541445,87.4799727
BIHAR,2002,Three Wheeler,47,9,56,25.78541445,87.4799727
BIHAR,2002,Two Wheeler,96,8,104,25.78541445,87.4799727
BIHAR,2002,Bicycle,17,3,20,25.78541445,87.4799727
BIHAR,2002,Pedestrian,40,2,42,25.78541445,87.4799727
BIHAR,2002,Others (Please Specify),289,58,347,25.78541445,87.4799727
BIHAR,2003,Truck/Lorry (Government),72,5,77,25.78541445,87.4799727
BIHAR,2003,Truck/Lorry (Private),562,84,646,25.78541445,87.4799727
BIHAR,2003,Bus (Government),10,0,10,25.78541445,87.4799727
BIHAR,2003,Bus (Private),215,45,260,25.78541445,87.4799727
BIHAR,2003,Tempo/Vans (Government),10,0,10,25.78541445,87.4799727
BIHAR,2003,Tempo/Vans (Private),171,39,210,25.78541445,87.4799727
BIHAR,2003,Jeep (Government),17,0,17,25.78541445,87.4799727
BIHAR,2003,Jeep (Private),249,70,319,25.78541445,87.4799727
BIHAR,2003,Car (Government),2,0,2,25.78541445,87.4799727
BIHAR,2003,Car (Private),87,25,112,25.78541445,87.4799727
BIHAR,2003,Three Wheeler,41,8,49,25.78541445,87.4799727
BIHAR,2003,Two Wheeler,131,18,149,25.78541445,87.4799727
BIHAR,2003,Bicycle,31,3,34,25.78541445,87.4799727
BIHAR,2003,Pedestrian,70,14,84,25.78541445,87.4799727
BIHAR,2003,Others (Please Specify),191,23,214,25.78541445,87.4799727
BIHAR,2004,Truck/Lorry (Government),11,9,20,25.78541445,87.4799727
BIHAR,2004,Truck/Lorry (Private),456,101,557,25.78541445,87.4799727
BIHAR,2004,Bus (Government),9,1,10,25.78541445,87.4799727
BIHAR,2004,Bus (Private),242,66,308,25.78541445,87.4799727
BIHAR,2004,Tempo/Vans (Government),1,0,1,25.78541445,87.4799727
BIHAR,2004,Tempo/Vans (Private),147,39,186,25.78541445,87.4799727
BIHAR,2004,Jeep (Government),5,2,7,25.78541445,87.4799727
BIHAR,2004,Jeep (Private),250,69,319,25.78541445,87.4799727
BIHAR,2004,Car (Government),3,0,3,25.78541445,87.4799727
BIHAR,2004,Car (Private),78,27,105,25.78541445,87.4799727
BIHAR,2004,Three Wheeler,22,2,24,25.78541445,87.4799727
BIHAR,2004,Two Wheeler,89,18,107,25.78541445,87.4799727
BIHAR,2004,Bicycle,27,0,27,25.78541445,87.4799727
BIHAR,2004,Pedestrian,79,29,108,25.78541445,87.4799727
BIHAR,2004,Others (Please Specify),241,76,317,25.78541445,87.4799727
BIHAR,2005,Truck/Lorry (Government),28,9,37,25.78541445,87.4799727
BIHAR,2005,Truck/Lorry (Private),437,67,504,25.78541445,87.4799727
BIHAR,2005,Bus (Government),40,6,46,25.78541445,87.4799727
BIHAR,2005,Bus (Private),260,61,321,25.78541445,87.4799727
BIHAR,2005,Tempo/Vans (Government),17,1,18,25.78541445,87.4799727
BIHAR,2005,Tempo/Vans (Private),71,26,97,25.78541445,87.4799727
BIHAR,2005,Jeep (Government),8,2,10,25.78541445,87.4799727
BIHAR,2005,Jeep (Private),230,77,307,25.78541445,87.4799727
BIHAR,2005,Car (Government),18,0,18,25.78541445,87.4799727
BIHAR,2005,Car (Private),100,24,124,25.78541445,87.4799727
BIHAR,2005,Three Wheeler,52,10,62,25.78541445,87.4799727
BIHAR,2005,Two Wheeler,87,14,101,25.78541445,87.4799727
BIHAR,2005,Bicycle,36,1,37,25.78541445,87.4799727
BIHAR,2005,Pedestrian,35,9,44,25.78541445,87.4799727
BIHAR,2005,Others (Please Specify),365,57,422,25.78541445,87.4799727
BIHAR,2006,Truck/Lorry (Government),17,7,24,25.78541445,87.4799727
BIHAR,2006,Truck/Lorry (Private),460,73,533,25.78541445,87.4799727
BIHAR,2006,Bus (Government),28,2,30,25.78541445,87.4799727
BIHAR,2006,Bus (Private),270,67,337,25.78541445,87.4799727
BIHAR,2006,Tempo/Vans (Government),9,2,11,25.78541445,87.4799727
BIHAR,2006,Tempo/Vans (Private),231,40,271,25.78541445,87.4799727
BIHAR,2006,Jeep (Government),18,10,28,25.78541445,87.4799727
BIHAR,2006,Jeep (Private),197,37,234,25.78541445,87.4799727
BIHAR,2006,Car (Government),29,2,31,25.78541445,87.4799727
BIHAR,2006,Car (Private),77,28,105,25.78541445,87.4799727
BIHAR,2006,Three Wheeler,32,8,40,25.78541445,87.4799727
BIHAR,2006,Two Wheeler,131,23,154,25.78541445,87.4799727
BIHAR,2006,Bicycle,60,4,64,25.78541445,87.4799727
BIHAR,2006,Pedestrian,45,11,56,25.78541445,87.4799727
BIHAR,2006,Others (Please Specify),248,65,313,25.78541445,87.4799727
BIHAR,2007,Truck/Lorry (Government),2,3,5,25.78541445,87.4799727
BIHAR,2007,Truck/Lorry (Private),571,88,659,25.78541445,87.4799727
BIHAR,2007,Bus (Government),12,13,25,25.78541445,87.4799727
BIHAR,2007,Bus (Private),323,92,415,25.78541445,87.4799727
BIHAR,2007,Tempo/Vans (Government),2,0,2,25.78541445,87.4799727
BIHAR,2007,Tempo/Vans (Private),160,57,217,25.78541445,87.4799727
BIHAR,2007,Jeep (Government),13,10,23,25.78541445,87.4799727
BIHAR,2007,Jeep (Private),316,82,398,25.78541445,87.4799727
BIHAR,2007,Car (Government),10,6,16,25.78541445,87.4799727
BIHAR,2007,Car (Private),100,42,142,25.78541445,87.4799727
BIHAR,2007,Three Wheeler,122,33,155,25.78541445,87.4799727
BIHAR,2007,Two Wheeler,202,47,249,25.78541445,87.4799727
BIHAR,2007,Bicycle,61,4,65,25.78541445,87.4799727
BIHAR,2007,Pedestrian,66,35,101,25.78541445,87.4799727
BIHAR,2007,Others (Please Specify),243,89,332,25.78541445,87.4799727
BIHAR,2008,Truck/Lorry (Government),6,4,10,25.78541445,87.4799727
BIHAR,2008,Truck/Lorry (Private),701,153,854,25.78541445,87.4799727
BIHAR,2008,Bus (Government),12,1,13,25.78541445,87.4799727
BIHAR,2008,Bus (Private),301,51,352,25.78541445,87.4799727
BIHAR,2008,Tempo/Vans (Government),8,2,10,25.78541445,87.4799727
BIHAR,2008,Tempo/Vans (Private),185,40,225,25.78541445,87.4799727
BIHAR,2008,Jeep (Government),30,8,38,25.78541445,87.4799727
BIHAR,2008,Jeep (Private),388,87,475,25.78541445,87.4799727
BIHAR,2008,Car (Government),1,1,2,25.78541445,87.4799727
BIHAR,2008,Car (Private),103,21,124,25.78541445,87.4799727
BIHAR,2008,Three Wheeler,82,18,100,25.78541445,87.4799727
BIHAR,2008,Two Wheeler,363,36,399,25.78541445,87.4799727
BIHAR,2008,Bicycle,52,5,57,25.78541445,87.4799727
BIHAR,2008,Pedestrian,92,23,115,25.78541445,87.4799727
BIHAR,2008,Others (Please Specify),630,67,697,25.78541445,87.4799727
BIHAR,2009,Truck/Lorry (Government),53,17,70,25.78541445,87.4799727
BIHAR,2009,Truck/Lorry (Private),852,140,992,25.78541445,87.4799727
BIHAR,2009,Bus (Government),49,10,59,25.78541445,87.4799727
BIHAR,2009,Bus (Private),329,86,415,25.78541445,87.4799727
BIHAR,2009,Tempo/Vans (Government),36,0,36,25.78541445,87.4799727
BIHAR,2009,Tempo/Vans (Private),341,77,418,25.78541445,87.4799727
BIHAR,2009,Jeep (Government),3,1,4,25.78541445,87.4799727
BIHAR,2009,Jeep (Private),435,111,546,25.78541445,87.4799727
BIHAR,2009,Car (Government),6,0,6,25.78541445,87.4799727
BIHAR,2009,Car (Private),158,30,188,25.78541445,87.4799727
BIHAR,2009,Three Wheeler,95,53,148,25.78541445,87.4799727
BIHAR,2009,Two Wheeler,355,48,403,25.78541445,87.4799727
BIHAR,2009,Bicycle,67,12,79,25.78541445,87.4799727
BIHAR,2009,Pedestrian,220,58,278,25.78541445,87.4799727
BIHAR,2009,Others (Please Specify),600,163,763,25.78541445,87.4799727
BIHAR,2010,Truck/Lorry (Government),43,5,48,25.78541445,87.4799727
BIHAR,2010,Truck/Lorry (Private),1040,132,1172,25.78541445,87.4799727
BIHAR,2010,Bus (Government),12,7,19,25.78541445,87.4799727
BIHAR,2010,Bus (Private),403,122,525,25.78541445,87.4799727
BIHAR,2010,Tempo/Vans (Government),3,0,3,25.78541445,87.4799727
BIHAR,2010,Tempo/Vans (Private),248,81,329,25.78541445,87.4799727
BIHAR,2010,Jeep (Government),10,3,13,25.78541445,87.4799727
BIHAR,2010,Jeep (Private),399,123,522,25.78541445,87.4799727
BIHAR,2010,Car (Government),15,1,16,25.78541445,87.4799727
BIHAR,2010,Car (Private),224,51,275,25.78541445,87.4799727
BIHAR,2010,Three Wheeler,223,64,287,25.78541445,87.4799727
BIHAR,2010,Two Wheeler,335,58,393,25.78541445,87.4799727
BIHAR,2010,Bicycle,86,19,105,25.78541445,87.4799727
BIHAR,2010,Pedestrian,235,31,266,25.78541445,87.4799727
BIHAR,2010,Others (Please Specify),624,96,720,25.78541445,87.4799727
BIHAR,2011,Truck/Lorry (Government),35,13,48,25.78541445,87.4799727
BIHAR,2011,Truck/Lorry (Private),949,149,1098,25.78541445,87.4799727
BIHAR,2011,Bus (Government),31,10,41,25.78541445,87.4799727
BIHAR,2011,Bus (Private),592,122,714,25.78541445,87.4799727
BIHAR,2011,Tempo/Vans (Government),4,0,4,25.78541445,87.4799727
BIHAR,2011,Tempo/Vans (Private),306,71,377,25.78541445,87.4799727
BIHAR,2011,Jeep (Government),12,2,14,25.78541445,87.4799727
BIHAR,2011,Jeep (Private),370,71,441,25.78541445,87.4799727
BIHAR,2011,Car (Government),1,0,1,25.78541445,87.4799727
BIHAR,2011,Car (Private),301,48,349,25.78541445,87.4799727
BIHAR,2011,Three Wheeler,187,25,212,25.78541445,87.4799727
BIHAR,2011,Two Wheeler,535,88,623,25.78541445,87.4799727
BIHAR,2011,Bicycle,108,28,136,25.78541445,87.4799727
BIHAR,2011,Pedestrian,118,34,152,25.78541445,87.4799727
BIHAR,2011,Others (Please Specify),726,136,862,25.78541445,87.4799727
BIHAR,2012,Truck/Lorry (Government),16,0,16,25.78541445,87.4799727
BIHAR,2012,Truck/Lorry (Private),823,133,956,25.78541445,87.4799727
BIHAR,2012,Bus (Government),23,2,25,25.78541445,87.4799727
BIHAR,2012,Bus (Private),738,126,864,25.78541445,87.4799727
BIHAR,2012,Tempo/Vans (Government),1,0,1,25.78541445,87.4799727
BIHAR,2012,Tempo/Vans (Private),361,81,442,25.78541445,87.4799727
BIHAR,2012,Jeep (Government),7,1,8,25.78541445,87.4799727
BIHAR,2012,Jeep (Private),393,79,472,25.78541445,87.4799727
BIHAR,2012,Car (Government),13,0,13,25.78541445,87.4799727
BIHAR,2012,Car (Private),223,62,285,25.78541445,87.4799727
BIHAR,2012,Three Wheeler,179,31,210,25.78541445,87.4799727
BIHAR,2012,Two Wheeler,549,89,638,25.78541445,87.4799727
BIHAR,2012,Bicycle,88,7,95,25.78541445,87.4799727
BIHAR,2012,Pedestrian,145,49,194,25.78541445,87.4799727
BIHAR,2012,Others (Please Specify),693,144,837,25.78541445,87.4799727
CHHATTISGARH,2001,Truck/Lorry (Government),38,17,55,22.09042035,82.15998734
CHHATTISGARH,2001,Truck/Lorry (Private),372,64,436,22.09042035,82.15998734
CHHATTISGARH,2001,Bus (Government),53,10,63,22.09042035,82.15998734
CHHATTISGARH,2001,Bus (Private),16,4,20,22.09042035,82.15998734
CHHATTISGARH,2001,Tempo/Vans (Government),14,4,18,22.09042035,82.15998734
CHHATTISGARH,2001,Tempo/Vans (Private),52,13,65,22.09042035,82.15998734
CHHATTISGARH,2001,Jeep (Government),9,3,12,22.09042035,82.15998734
CHHATTISGARH,2001,Jeep (Private),133,22,155,22.09042035,82.15998734
CHHATTISGARH,2001,Car (Government),1,0,1,22.09042035,82.15998734
CHHATTISGARH,2001,Car (Private),30,5,35,22.09042035,82.15998734
CHHATTISGARH,2001,Three Wheeler,10,1,11,22.09042035,82.15998734
CHHATTISGARH,2001,Two Wheeler,202,21,223,22.09042035,82.15998734
CHHATTISGARH,2001,Bicycle,36,5,41,22.09042035,82.15998734
CHHATTISGARH,2001,Pedestrian,48,17,65,22.09042035,82.15998734
CHHATTISGARH,2001,Others (Please Specify),129,11,140,22.09042035,82.15998734
CHHATTISGARH,2002,Truck/Lorry (Government),5,0,5,22.09042035,82.15998734
CHHATTISGARH,2002,Truck/Lorry (Private),356,63,419,22.09042035,82.15998734
CHHATTISGARH,2002,Bus (Government),5,0,5,22.09042035,82.15998734
CHHATTISGARH,2002,Bus (Private),86,23,109,22.09042035,82.15998734
CHHATTISGARH,2002,Tempo/Vans (Government),0,0,0,22.09042035,82.15998734
CHHATTISGARH,2002,Tempo/Vans (Private),50,17,67,22.09042035,82.15998734
CHHATTISGARH,2002,Jeep (Government),2,0,2,22.09042035,82.15998734
CHHATTISGARH,2002,Jeep (Private),164,33,197,22.09042035,82.15998734
CHHATTISGARH,2002,Car (Government),0,0,0,22.09042035,82.15998734
CHHATTISGARH,2002,Car (Private),37,4,41,22.09042035,82.15998734
CHHATTISGARH,2002,Three Wheeler,14,1,15,22.09042035,82.15998734
CHHATTISGARH,2002,Two Wheeler,316,28,344,22.09042035,82.15998734
CHHATTISGARH,2002,Bicycle,123,15,138,22.09042035,82.15998734
CHHATTISGARH,2002,Pedestrian,115,40,155,22.09042035,82.15998734
CHHATTISGARH,2002,Others (Please Specify),283,44,327,22.09042035,82.15998734
CHHATTISGARH,2003,Truck/Lorry (Government),22,3,25,22.09042035,82.15998734
CHHATTISGARH,2003,Truck/Lorry (Private),503,89,592,22.09042035,82.15998734
CHHATTISGARH,2003,Bus (Government),0,0,0,22.09042035,82.15998734
CHHATTISGARH,2003,Bus (Private),132,22,154,22.09042035,82.15998734
CHHATTISGARH,2003,Tempo/Vans (Government),0,0,0,22.09042035,82.15998734
CHHATTISGARH,2003,Tempo/Vans (Private),59,11,70,22.09042035,82.15998734
CHHATTISGARH,2003,Jeep (Government),6,3,9,22.09042035,82.15998734
CHHATTISGARH,2003,Jeep (Private),192,30,222,22.09042035,82.15998734
CHHATTISGARH,2003,Car (Government),1,0,1,22.09042035,82.15998734
CHHATTISGARH,2003,Car (Private),57,3,60,22.09042035,82.15998734
CHHATTISGARH,2003,Three Wheeler,13,0,13,22.09042035,82.15998734
CHHATTISGARH,2003,Two Wheeler,296,37,333,22.09042035,82.15998734
CHHATTISGARH,2003,Bicycle,69,4,73,22.09042035,82.15998734
CHHATTISGARH,2003,Pedestrian,125,17,142,22.09042035,82.15998734
CHHATTISGARH,2003,Others (Please Specify),279,62,341,22.09042035,82.15998734
CHHATTISGARH,2004,Truck/Lorry (Government),15,3,18,22.09042035,82.15998734
CHHATTISGARH,2004,Truck/Lorry (Private),459,69,528,22.09042035,82.15998734
CHHATTISGARH,2004,Bus (Government),29,6,35,22.09042035,82.15998734
CHHATTISGARH,2004,Bus (Private),58,16,74,22.09042035,82.15998734
CHHATTISGARH,2004,Tempo/Vans (Government),1,0,1,22.09042035,82.15998734
CHHATTISGARH,2004,Tempo/Vans (Private),58,20,78,22.09042035,82.15998734
CHHATTISGARH,2004,Jeep (Government),9,2,11,22.09042035,82.15998734
CHHATTISGARH,2004,Jeep (Private),180,31,211,22.09042035,82.15998734
CHHATTISGARH,2004,Car (Government),0,0,0,22.09042035,82.15998734
CHHATTISGARH,2004,Car (Private),41,6,47,22.09042035,82.15998734
CHHATTISGARH,2004,Three Wheeler,27,2,29,22.09042035,82.15998734
CHHATTISGARH,2004,Two Wheeler,405,40,445,22.09042035,82.15998734
CHHATTISGARH,2004,Bicycle,68,10,78,22.09042035,82.15998734
CHHATTISGARH,2004,Pedestrian,153,48,201,22.09042035,82.15998734
CHHATTISGARH,2004,Others (Please Specify),417,77,494,22.09042035,82.15998734
CHHATTISGARH,2005,Truck/Lorry (Government),0,0,0,22.09042035,82.15998734
CHHATTISGARH,2005,Truck/Lorry (Private),454,80,534,22.09042035,82.15998734
CHHATTISGARH,2005,Bus (Government),0,0,0,22.09042035,82.15998734
CHHATTISGARH,2005,Bus (Private),167,37,204,22.09042035,82.15998734
CHHATTISGARH,2005,Tempo/Vans (Government),1,0,1,22.09042035,82.15998734
CHHATTISGARH,2005,Tempo/Vans (Private),82,13,95,22.09042035,82.15998734
CHHATTISGARH,2005,Jeep (Government),1,0,1,22.09042035,82.15998734
CHHATTISGARH,2005,Jeep (Private),204,35,239,22.09042035,82.15998734
CHHATTISGARH,2005,Car (Government),3,0,3,22.09042035,82.15998734
CHHATTISGARH,2005,Car (Private),75,7,82,22.09042035,82.15998734
CHHATTISGARH,2005,Three Wheeler,12,3,15,22.09042035,82.15998734
CHHATTISGARH,2005,Two Wheeler,397,60,457,22.09042035,82.15998734
CHHATTISGARH,2005,Bicycle,152,4,156,22.09042035,82.15998734
CHHATTISGARH,2005,Pedestrian,179,27,206,22.09042035,82.15998734
CHHATTISGARH,2005,Others (Please Specify),302,30,332,22.09042035,82.15998734
CHHATTISGARH,2006,Truck/Lorry (Government),2,0,2,22.09042035,82.15998734
CHHATTISGARH,2006,Truck/Lorry (Private),652,112,764,22.09042035,82.15998734
CHHATTISGARH,2006,Bus (Government),0,0,0,22.09042035,82.15998734
CHHATTISGARH,2006,Bus (Private),140,30,170,22.09042035,82.15998734
CHHATTISGARH,2006,Tempo/Vans (Government),3,0,3,22.09042035,82.15998734
CHHATTISGARH,2006,Tempo/Vans (Private),71,6,77,22.09042035,82.15998734
CHHATTISGARH,2006,Jeep (Government),0,1,1,22.09042035,82.15998734
CHHATTISGARH,2006,Jeep (Private),164,32,196,22.09042035,82.15998734
CHHATTISGARH,2006,Car (Government),2,0,2,22.09042035,82.15998734
CHHATTISGARH,2006,Car (Private),82,27,109,22.09042035,82.15998734
CHHATTISGARH,2006,Three Wheeler,29,2,31,22.09042035,82.15998734
CHHATTISGARH,2006,Two Wheeler,377,64,441,22.09042035,82.15998734
CHHATTISGARH,2006,Bicycle,148,11,159,22.09042035,82.15998734
CHHATTISGARH,2006,Pedestrian,114,22,136,22.09042035,82.15998734
CHHATTISGARH,2006,Others (Please Specify),424,59,483,22.09042035,82.15998734
CHHATTISGARH,2007,Truck/Lorry (Government),0,0,0,22.09042035,82.15998734
CHHATTISGARH,2007,Truck/Lorry (Private),649,70,719,22.09042035,82.15998734
CHHATTISGARH,2007,Bus (Government),0,0,0,22.09042035,82.15998734
CHHATTISGARH,2007,Bus (Private),161,27,188,22.09042035,82.15998734
CHHATTISGARH,2007,Tempo/Vans (Government),0,0,0,22.09042035,82.15998734
CHHATTISGARH,2007,Tempo/Vans (Private),81,9,90,22.09042035,82.15998734
CHHATTISGARH,2007,Jeep (Government),4,1,5,22.09042035,82.15998734
CHHATTISGARH,2007,Jeep (Private),151,44,195,22.09042035,82.15998734
CHHATTISGARH,2007,Car (Government),9,0,9,22.09042035,82.15998734
CHHATTISGARH,2007,Car (Private),110,17,127,22.09042035,82.15998734
CHHATTISGARH,2007,Three Wheeler,27,1,28,22.09042035,82.15998734
CHHATTISGARH,2007,Two Wheeler,494,66,560,22.09042035,82.15998734
CHHATTISGARH,2007,Bicycle,70,9,79,22.09042035,82.15998734
CHHATTISGARH,2007,Pedestrian,137,29,166,22.09042035,82.15998734
CHHATTISGARH,2007,Others (Please Specify),636,130,766,22.09042035,82.15998734
CHHATTISGARH,2008,Truck/Lorry (Government),0,0,0,22.09042035,82.15998734
CHHATTISGARH,2008,Truck/Lorry (Private),698,92,790,22.09042035,82.15998734
CHHATTISGARH,2008,Bus (Government),92,14,106,22.09042035,82.15998734
CHHATTISGARH,2008,Bus (Private),49,14,63,22.09042035,82.15998734
CHHATTISGARH,2008,Tempo/Vans (Government),0,0,0,22.09042035,82.15998734
CHHATTISGARH,2008,Tempo/Vans (Private),83,20,103,22.09042035,82.15998734
CHHATTISGARH,2008,Jeep (Government),0,1,1,22.09042035,82.15998734
CHHATTISGARH,2008,Jeep (Private),176,31,207,22.09042035,82.15998734
CHHATTISGARH,2008,Car (Government),1,0,1,22.09042035,82.15998734
CHHATTISGARH,2008,Car (Private),105,13,118,22.09042035,82.15998734
CHHATTISGARH,2008,Three Wheeler,27,2,29,22.09042035,82.15998734
CHHATTISGARH,2008,Two Wheeler,757,70,827,22.09042035,82.15998734
CHHATTISGARH,2008,Bicycle,77,7,84,22.09042035,82.15998734
CHHATTISGARH,2008,Pedestrian,165,48,213,22.09042035,82.15998734
CHHATTISGARH,2008,Others (Please Specify),615,86,701,22.09042035,82.15998734
CHHATTISGARH,2009,Truck/Lorry (Government),46,0,46,22.09042035,82.15998734
CHHATTISGARH,2009,Truck/Lorry (Private),522,69,591,22.09042035,82.15998734
CHHATTISGARH,2009,Bus (Government),10,1,11,22.09042035,82.15998734
CHHATTISGARH,2009,Bus (Private),132,36,168,22.09042035,82.15998734
CHHATTISGARH,2009,Tempo/Vans (Government),0,0,0,22.09042035,82.15998734
CHHATTISGARH,2009,Tempo/Vans (Private),113,19,132,22.09042035,82.15998734
CHHATTISGARH,2009,Jeep (Government),3,0,3,22.09042035,82.15998734
CHHATTISGARH,2009,Jeep (Private),228,42,270,22.09042035,82.15998734
CHHATTISGARH,2009,Car (Government),0,0,0,22.09042035,82.15998734
CHHATTISGARH,2009,Car (Private),140,17,157,22.09042035,82.15998734
CHHATTISGARH,2009,Three Wheeler,45,5,50,22.09042035,82.15998734
CHHATTISGARH,2009,Two Wheeler,636,78,714,22.09042035,82.15998734
CHHATTISGARH,2009,Bicycle,120,13,133,22.09042035,82.15998734
CHHATTISGARH,2009,Pedestrian,152,47,199,22.09042035,82.15998734
CHHATTISGARH,2009,Others (Please Specify),596,88,684,22.09042035,82.15998734
CHHATTISGARH,2010,Truck/Lorry (Government),154,20,174,22.09042035,82.15998734
CHHATTISGARH,2010,Truck/Lorry (Private),452,72,524,22.09042035,82.15998734
CHHATTISGARH,2010,Bus (Government),85,8,93,22.09042035,82.15998734
CHHATTISGARH,2010,Bus (Private),137,21,158,22.09042035,82.15998734
CHHATTISGARH,2010,Tempo/Vans (Government),0,0,0,22.09042035,82.15998734
CHHATTISGARH,2010,Tempo/Vans (Private),128,16,144,22.09042035,82.15998734
CHHATTISGARH,2010,Jeep (Government),23,1,24,22.09042035,82.15998734
CHHATTISGARH,2010,Jeep (Private),209,38,247,22.09042035,82.15998734
CHHATTISGARH,2010,Car (Government),0,0,0,22.09042035,82.15998734
CHHATTISGARH,2010,Car (Private),149,16,165,22.09042035,82.15998734
CHHATTISGARH,2010,Three Wheeler,45,5,50,22.09042035,82.15998734
CHHATTISGARH,2010,Two Wheeler,344,51,395,22.09042035,82.15998734
CHHATTISGARH,2010,Bicycle,148,12,160,22.09042035,82.15998734
CHHATTISGARH,2010,Pedestrian,196,27,223,22.09042035,82.15998734
CHHATTISGARH,2010,Others (Please Specify),451,80,531,22.09042035,82.15998734
CHHATTISGARH,2011,Truck/Lorry (Government),1,4,5,22.09042035,82.15998734
CHHATTISGARH,2011,Truck/Lorry (Private),724,87,811,22.09042035,82.15998734
CHHATTISGARH,2011,Bus (Government),18,6,24,22.09042035,82.15998734
CHHATTISGARH,2011,Bus (Private),135,20,155,22.09042035,82.15998734
CHHATTISGARH,2011,Tempo/Vans (Government),1,0,1,22.09042035,82.15998734
CHHATTISGARH,2011,Tempo/Vans (Private),162,27,189,22.09042035,82.15998734
CHHATTISGARH,2011,Jeep (Government),18,6,24,22.09042035,82.15998734
CHHATTISGARH,2011,Jeep (Private),249,29,278,22.09042035,82.15998734
CHHATTISGARH,2011,Car (Government),1,0,1,22.09042035,82.15998734
CHHATTISGARH,2011,Car (Private),144,21,165,22.09042035,82.15998734
CHHATTISGARH,2011,Three Wheeler,76,9,85,22.09042035,82.15998734
CHHATTISGARH,2011,Two Wheeler,820,101,921,22.09042035,82.15998734
CHHATTISGARH,2011,Bicycle,118,12,130,22.09042035,82.15998734
CHHATTISGARH,2011,Pedestrian,190,50,240,22.09042035,82.15998734
CHHATTISGARH,2011,Others (Please Specify),370,55,425,22.09042035,82.15998734
CHHATTISGARH,2012,Truck/Lorry (Government),3,1,4,22.09042035,82.15998734
CHHATTISGARH,2012,Truck/Lorry (Private),709,87,796,22.09042035,82.15998734
CHHATTISGARH,2012,Bus (Government),22,5,27,22.09042035,82.15998734
CHHATTISGARH,2012,Bus (Private),102,18,120,22.09042035,82.15998734
CHHATTISGARH,2012,Tempo/Vans (Government),1,0,1,22.09042035,82.15998734
CHHATTISGARH,2012,Tempo/Vans (Private),74,16,90,22.09042035,82.15998734
CHHATTISGARH,2012,Jeep (Government),6,3,9,22.09042035,82.15998734
CHHATTISGARH,2012,Jeep (Private),183,28,211,22.09042035,82.15998734
CHHATTISGARH,2012,Car (Government),0,0,0,22.09042035,82.15998734
CHHATTISGARH,2012,Car (Private),119,20,139,22.09042035,82.15998734
CHHATTISGARH,2012,Three Wheeler,21,3,24,22.09042035,82.15998734
CHHATTISGARH,2012,Two Wheeler,655,80,735,22.09042035,82.15998734
CHHATTISGARH,2012,Bicycle,59,5,64,22.09042035,82.15998734
CHHATTISGARH,2012,Pedestrian,141,48,189,22.09042035,82.15998734
CHHATTISGARH,2012,Others (Please Specify),641,117,758,22.09042035,82.15998734
GOA,2001,Truck/Lorry (Government),0,0,0,15.491997,73.81800065
GOA,2001,Truck/Lorry (Private),21,6,27,15.491997,73.81800065
GOA,2001,Bus (Government),1,0,1,15.491997,73.81800065
GOA,2001,Bus (Private),10,5,15,15.491997,73.81800065
GOA,2001,Tempo/Vans (Government),2,0,2,15.491997,73.81800065
GOA,2001,Tempo/Vans (Private),6,1,7,15.491997,73.81800065
GOA,2001,Jeep (Government),0,0,0,15.491997,73.81800065
GOA,2001,Jeep (Private),4,1,5,15.491997,73.81800065
GOA,2001,Car (Government),0,0,0,15.491997,73.81800065
GOA,2001,Car (Private),10,0,10,15.491997,73.81800065
GOA,2001,Three Wheeler,7,0,7,15.491997,73.81800065
GOA,2001,Two Wheeler,84,9,93,15.491997,73.81800065
GOA,2001,Bicycle,7,1,8,15.491997,73.81800065
GOA,2001,Pedestrian,27,15,42,15.491997,73.81800065
GOA,2001,Others (Please Specify),9,1,10,15.491997,73.81800065
GOA,2002,Truck/Lorry (Government),0,0,0,15.491997,73.81800065
GOA,2002,Truck/Lorry (Private),1,1,2,15.491997,73.81800065
GOA,2002,Bus (Government),1,0,1,15.491997,73.81800065
GOA,2002,Bus (Private),5,0,5,15.491997,73.81800065
GOA,2002,Tempo/Vans (Government),0,0,0,15.491997,73.81800065
GOA,2002,Tempo/Vans (Private),2,0,2,15.491997,73.81800065
GOA,2002,Jeep (Government),0,0,0,15.491997,73.81800065
GOA,2002,Jeep (Private),1,0,1,15.491997,73.81800065
GOA,2002,Car (Government),0,0,0,15.491997,73.81800065
GOA,2002,Car (Private),3,1,4,15.491997,73.81800065
GOA,2002,Three Wheeler,13,6,19,15.491997,73.81800065
GOA,2002,Two Wheeler,38,1,39,15.491997,73.81800065
GOA,2002,Bicycle,3,0,3,15.491997,73.81800065
GOA,2002,Pedestrian,18,4,22,15.491997,73.81800065
GOA,2002,Others (Please Specify),125,18,143,15.491997,73.81800065
GOA,2003,Truck/Lorry (Government),0,0,0,15.491997,73.81800065
GOA,2003,Truck/Lorry (Private),19,0,19,15.491997,73.81800065
GOA,2003,Bus (Government),4,2,6,15.491997,73.81800065
GOA,2003,Bus (Private),7,2,9,15.491997,73.81800065
GOA,2003,Tempo/Vans (Government),0,0,0,15.491997,73.81800065
GOA,2003,Tempo/Vans (Private),11,1,12,15.491997,73.81800065
GOA,2003,Jeep (Government),0,0,0,15.491997,73.81800065
GOA,2003,Jeep (Private),3,0,3,15.491997,73.81800065
GOA,2003,Car (Government),0,0,0,15.491997,73.81800065
GOA,2003,Car (Private),7,0,7,15.491997,73.81800065
GOA,2003,Three Wheeler,14,1,15,15.491997,73.81800065
GOA,2003,Two Wheeler,91,10,101,15.491997,73.81800065
GOA,2003,Bicycle,8,0,8,15.491997,73.81800065
GOA,2003,Pedestrian,28,14,42,15.491997,73.81800065
GOA,2003,Others (Please Specify),9,0,9,15.491997,73.81800065
GOA,2004,Truck/Lorry (Government),0,0,0,15.491997,73.81800065
GOA,2004,Truck/Lorry (Private),18,3,21,15.491997,73.81800065
GOA,2004,Bus (Government),0,0,0,15.491997,73.81800065
GOA,2004,Bus (Private),10,1,11,15.491997,73.81800065
GOA,2004,Tempo/Vans (Government),1,0,1,15.491997,73.81800065
GOA,2004,Tempo/Vans (Private),6,1,7,15.491997,73.81800065
GOA,2004,Jeep (Government),0,0,0,15.491997,73.81800065
GOA,2004,Jeep (Private),6,0,6,15.491997,73.81800065
GOA,2004,Car (Government),0,0,0,15.491997,73.81800065
GOA,2004,Car (Private),17,4,21,15.491997,73.81800065
GOA,2004,Three Wheeler,10,1,11,15.491997,73.81800065
GOA,2004,Two Wheeler,139,14,153,15.491997,73.81800065
GOA,2004,Bicycle,11,0,11,15.491997,73.81800065
GOA,2004,Pedestrian,47,22,69,15.491997,73.81800065
GOA,2004,Others (Please Specify),7,1,8,15.491997,73.81800065
GOA,2005,Truck/Lorry (Government),0,0,0,15.491997,73.81800065
GOA,2005,Truck/Lorry (Private),16,2,18,15.491997,73.81800065
GOA,2005,Bus (Government),0,0,0,15.491997,73.81800065
GOA,2005,Bus (Private),3,0,3,15.491997,73.81800065
GOA,2005,Tempo/Vans (Government),0,0,0,15.491997,73.81800065
GOA,2005,Tempo/Vans (Private),6,0,6,15.491997,73.81800065
GOA,2005,Jeep (Government),0,0,0,15.491997,73.81800065
GOA,2005,Jeep (Private),5,0,5,15.491997,73.81800065
GOA,2005,Car (Government),0,0,0,15.491997,73.81800065
GOA,2005,Car (Private),14,3,17,15.491997,73.81800065
GOA,2005,Three Wheeler,6,1,7,15.491997,73.81800065
GOA,2005,Two Wheeler,129,8,137,15.491997,73.81800065
GOA,2005,Bicycle,8,0,8,15.491997,73.81800065
GOA,2005,Pedestrian,39,17,56,15.491997,73.81800065
GOA,2005,Others (Please Specify),1,0,1,15.491997,73.81800065
GOA,2006,Truck/Lorry (Government),0,0,0,15.491997,73.81800065
GOA,2006,Truck/Lorry (Private),17,1,18,15.491997,73.81800065
GOA,2006,Bus (Government),0,0,0,15.491997,73.81800065
GOA,2006,Bus (Private),10,0,10,15.491997,73.81800065
GOA,2006,Tempo/Vans (Government),1,0,1,15.491997,73.81800065
GOA,2006,Tempo/Vans (Private),7,1,8,15.491997,73.81800065
GOA,2006,Jeep (Government),0,0,0,15.491997,73.81800065
GOA,2006,Jeep (Private),3,1,4,15.491997,73.81800065
GOA,2006,Car (Government),0,0,0,15.491997,73.81800065
GOA,2006,Car (Private),13,4,17,15.491997,73.81800065
GOA,2006,Three Wheeler,26,5,31,15.491997,73.81800065
GOA,2006,Two Wheeler,112,15,127,15.491997,73.81800065
GOA,2006,Bicycle,13,1,14,15.491997,73.81800065
GOA,2006,Pedestrian,56,18,74,15.491997,73.81800065
GOA,2006,Others (Please Specify),5,1,6,15.491997,73.81800065
GOA,2007,Truck/Lorry (Government),0,0,0,15.491997,73.81800065
GOA,2007,Truck/Lorry (Private),19,3,22,15.491997,73.81800065
GOA,2007,Bus (Government),1,0,1,15.491997,73.81800065
GOA,2007,Bus (Private),5,1,6,15.491997,73.81800065
GOA,2007,Tempo/Vans (Government),0,0,0,15.491997,73.81800065
GOA,2007,Tempo/Vans (Private),11,0,11,15.491997,73.81800065
GOA,2007,Jeep (Government),0,0,0,15.491997,73.81800065
GOA,2007,Jeep (Private),5,1,6,15.491997,73.81800065
GOA,2007,Car (Government),0,0,0,15.491997,73.81800065
GOA,2007,Car (Private),10,2,12,15.491997,73.81800065
GOA,2007,Three Wheeler,1,1,2,15.491997,73.81800065
GOA,2007,Two Wheeler,174,19,193,15.491997,73.81800065
GOA,2007,Bicycle,12,0,12,15.491997,73.81800065
GOA,2007,Pedestrian,54,14,68,15.491997,73.81800065
GOA,2007,Others (Please Specify),7,0,7,15.491997,73.81800065
GOA,2008,Truck/Lorry (Government),0,0,0,15.491997,73.81800065
GOA,2008,Truck/Lorry (Private),23,0,23,15.491997,73.81800065
GOA,2008,Bus (Government),2,0,2,15.491997,73.81800065
GOA,2008,Bus (Private),13,8,21,15.491997,73.81800065
GOA,2008,Tempo/Vans (Government),0,0,0,15.491997,73.81800065
GOA,2008,Tempo/Vans (Private),10,1,11,15.491997,73.81800065
GOA,2008,Jeep (Government),1,0,1,15.491997,73.81800065
GOA,2008,Jeep (Private),17,1,18,15.491997,73.81800065
GOA,2008,Car (Government),0,0,0,15.491997,73.81800065
GOA,2008,Car (Private),12,2,14,15.491997,73.81800065
GOA,2008,Three Wheeler,14,1,15,15.491997,73.81800065
GOA,2008,Two Wheeler,138,11,149,15.491997,73.81800065
GOA,2008,Bicycle,10,2,12,15.491997,73.81800065
GOA,2008,Pedestrian,41,16,57,15.491997,73.81800065
GOA,2008,Others (Please Specify),9,1,10,15.491997,73.81800065
GOA,2009,Truck/Lorry (Government),0,0,0,15.491997,73.81800065
GOA,2009,Truck/Lorry (Private),26,0,26,15.491997,73.81800065
GOA,2009,Bus (Government),0,0,0,15.491997,73.81800065
GOA,2009,Bus (Private),1,0,1,15.491997,73.81800065
GOA,2009,Tempo/Vans (Government),0,0,0,15.491997,73.81800065
GOA,2009,Tempo/Vans (Private),7,0,7,15.491997,73.81800065
GOA,2009,Jeep (Government),0,0,0,15.491997,73.81800065
GOA,2009,Jeep (Private),4,1,5,15.491997,73.81800065
GOA,2009,Car (Government),0,0,0,15.491997,73.81800065
GOA,2009,Car (Private),16,3,19,15.491997,73.81800065
GOA,2009,Three Wheeler,4,0,4,15.491997,73.81800065
GOA,2009,Two Wheeler,168,12,180,15.491997,73.81800065
GOA,2009,Bicycle,7,0,7,15.491997,73.81800065
GOA,2009,Pedestrian,50,15,65,15.491997,73.81800065
GOA,2009,Others (Please Specify),6,4,10,15.491997,73.81800065
GOA,2010,Truck/Lorry (Government),1,0,1,15.491997,73.81800065
GOA,2010,Truck/Lorry (Private),10,1,11,15.491997,73.81800065
GOA,2010,Bus (Government),0,0,0,15.491997,73.81800065
GOA,2010,Bus (Private),7,4,11,15.491997,73.81800065
GOA,2010,Tempo/Vans (Government),0,0,0,15.491997,73.81800065
GOA,2010,Tempo/Vans (Private),2,0,2,15.491997,73.81800065
GOA,2010,Jeep (Government),1,0,1,15.491997,73.81800065
GOA,2010,Jeep (Private),7,0,7,15.491997,73.81800065
GOA,2010,Car (Government),0,0,0,15.491997,73.81800065
GOA,2010,Car (Private),15,3,18,15.491997,73.81800065
GOA,2010,Three Wheeler,2,0,2,15.491997,73.81800065
GOA,2010,Two Wheeler,167,24,191,15.491997,73.81800065
GOA,2010,Bicycle,5,0,5,15.491997,73.81800065
GOA,2010,Pedestrian,73,15,88,15.491997,73.81800065
GOA,2010,Others (Please Specify),5,0,5,15.491997,73.81800065
GOA,2011,Truck/Lorry (Government),0,0,0,15.491997,73.81800065
GOA,2011,Truck/Lorry (Private),16,1,17,15.491997,73.81800065
GOA,2011,Bus (Government),0,0,0,15.491997,73.81800065
GOA,2011,Bus (Private),8,0,8,15.491997,73.81800065
GOA,2011,Tempo/Vans (Government),0,0,0,15.491997,73.81800065
GOA,2011,Tempo/Vans (Private),4,1,5,15.491997,73.81800065
GOA,2011,Jeep (Government),1,0,1,15.491997,73.81800065
GOA,2011,Jeep (Private),5,2,7,15.491997,73.81800065
GOA,2011,Car (Government),0,0,0,15.491997,73.81800065
GOA,2011,Car (Private),12,3,15,15.491997,73.81800065
GOA,2011,Three Wheeler,3,0,3,15.491997,73.81800065
GOA,2011,Two Wheeler,152,11,163,15.491997,73.81800065
GOA,2011,Bicycle,15,0,15,15.491997,73.81800065
GOA,2011,Pedestrian,84,13,97,15.491997,73.81800065
GOA,2011,Others (Please Specify),5,2,7,15.491997,73.81800065
GOA,2012,Truck/Lorry (Government),0,0,0,15.491997,73.81800065
GOA,2012,Truck/Lorry (Private),10,0,10,15.491997,73.81800065
GOA,2012,Bus (Government),2,0,2,15.491997,73.81800065
GOA,2012,Bus (Private),6,7,13,15.491997,73.81800065
GOA,2012,Tempo/Vans (Government),0,0,0,15.491997,73.81800065
GOA,2012,Tempo/Vans (Private),2,0,2,15.491997,73.81800065
GOA,2012,Jeep (Government),0,0,0,15.491997,73.81800065
GOA,2012,Jeep (Private),1,0,1,15.491997,73.81800065
GOA,2012,Car (Government),0,0,0,15.491997,73.81800065
GOA,2012,Car (Private),23,4,27,15.491997,73.81800065
GOA,2012,Three Wheeler,11,2,13,15.491997,73.81800065
GOA,2012,Two Wheeler,162,11,173,15.491997,73.81800065
GOA,2012,Bicycle,2,0,2,15.491997,73.81800065
GOA,2012,Pedestrian,37,13,50,15.491997,73.81800065
GOA,2012,Others (Please Specify),9,0,9,15.491997,73.81800065
GUJARAT,2001,Truck/Lorry (Government),10,1,11,22.2587,71.1924
GUJARAT,2001,Truck/Lorry (Private),898,123,1021,22.2587,71.1924
GUJARAT,2001,Bus (Government),164,32,196,22.2587,71.1924
GUJARAT,2001,Bus (Private),149,40,189,22.2587,71.1924
GUJARAT,2001,Tempo/Vans (Government),1,0,1,22.2587,71.1924
GUJARAT,2001,Tempo/Vans (Private),241,59,300,22.2587,71.1924
GUJARAT,2001,Jeep (Government),8,0,8,22.2587,71.1924
GUJARAT,2001,Jeep (Private),411,91,502,22.2587,71.1924
GUJARAT,2001,Car (Government),2,1,3,22.2587,71.1924
GUJARAT,2001,Car (Private),205,53,258,22.2587,71.1924
GUJARAT,2001,Three Wheeler,224,51,275,22.2587,71.1924
GUJARAT,2001,Two Wheeler,521,94,615,22.2587,71.1924
GUJARAT,2001,Bicycle,161,15,176,22.2587,71.1924
GUJARAT,2001,Pedestrian,490,119,609,22.2587,71.1924
GUJARAT,2001,Others (Please Specify),265,42,307,22.2587,71.1924
GUJARAT,2002,Truck/Lorry (Government),6,0,6,22.2587,71.1924
GUJARAT,2002,Truck/Lorry (Private),1044,120,1164,22.2587,71.1924
GUJARAT,2002,Bus (Government),117,31,148,22.2587,71.1924
GUJARAT,2002,Bus (Private),119,32,151,22.2587,71.1924
GUJARAT,2002,Tempo/Vans (Government),3,1,4,22.2587,71.1924
GUJARAT,2002,Tempo/Vans (Private),300,72,372,22.2587,71.1924
GUJARAT,2002,Jeep (Government),15,0,15,22.2587,71.1924
GUJARAT,2002,Jeep (Private),418,93,511,22.2587,71.1924
GUJARAT,2002,Car (Government),2,0,2,22.2587,71.1924
GUJARAT,2002,Car (Private),212,51,263,22.2587,71.1924
GUJARAT,2002,Three Wheeler,294,55,349,22.2587,71.1924
GUJARAT,2002,Two Wheeler,563,88,651,22.2587,71.1924
GUJARAT,2002,Bicycle,136,9,145,22.2587,71.1924
GUJARAT,2002,Pedestrian,523,98,621,22.2587,71.1924
GUJARAT,2002,Others (Please Specify),260,53,313,22.2587,71.1924
GUJARAT,2003,Truck/Lorry (Government),2,0,2,22.2587,71.1924
GUJARAT,2003,Truck/Lorry (Private),979,147,1126,22.2587,71.1924
GUJARAT,2003,Bus (Government),123,38,161,22.2587,71.1924
GUJARAT,2003,Bus (Private),170,40,210,22.2587,71.1924
GUJARAT,2003,Tempo/Vans (Government),0,0,0,22.2587,71.1924
GUJARAT,2003,Tempo/Vans (Private),273,61,334,22.2587,71.1924
GUJARAT,2003,Jeep (Government),6,4,10,22.2587,71.1924
GUJARAT,2003,Jeep (Private),444,119,563,22.2587,71.1924
GUJARAT,2003,Car (Government),4,2,6,22.2587,71.1924
GUJARAT,2003,Car (Private),251,89,340,22.2587,71.1924
GUJARAT,2003,Three Wheeler,272,80,352,22.2587,71.1924
GUJARAT,2003,Two Wheeler,549,97,646,22.2587,71.1924
GUJARAT,2003,Bicycle,149,12,161,22.2587,71.1924
GUJARAT,2003,Pedestrian,480,82,562,22.2587,71.1924
GUJARAT,2003,Others (Please Specify),296,44,340,22.2587,71.1924
GUJARAT,2004,Truck/Lorry (Government),9,1,10,22.2587,71.1924
GUJARAT,2004,Truck/Lorry (Private),943,110,1053,22.2587,71.1924
GUJARAT,2004,Bus (Government),109,30,139,22.2587,71.1924
GUJARAT,2004,Bus (Private),109,28,137,22.2587,71.1924
GUJARAT,2004,Tempo/Vans (Government),2,0,2,22.2587,71.1924
GUJARAT,2004,Tempo/Vans (Private),258,38,296,22.2587,71.1924
GUJARAT,2004,Jeep (Government),7,2,9,22.2587,71.1924
GUJARAT,2004,Jeep (Private),527,85,612,22.2587,71.1924
GUJARAT,2004,Car (Government),5,0,5,22.2587,71.1924
GUJARAT,2004,Car (Private),302,72,374,22.2587,71.1924
GUJARAT,2004,Three Wheeler,352,87,439,22.2587,71.1924
GUJARAT,2004,Two Wheeler,721,93,814,22.2587,71.1924
GUJARAT,2004,Bicycle,148,9,157,22.2587,71.1924
GUJARAT,2004,Pedestrian,473,106,579,22.2587,71.1924
GUJARAT,2004,Others (Please Specify),264,58,322,22.2587,71.1924
GUJARAT,2005,Truck/Lorry (Government),118,32,150,22.2587,71.1924
GUJARAT,2005,Truck/Lorry (Private),896,131,1027,22.2587,71.1924
GUJARAT,2005,Bus (Government),113,25,138,22.2587,71.1924
GUJARAT,2005,Bus (Private),170,40,210,22.2587,71.1924
GUJARAT,2005,Tempo/Vans (Government),10,47,57,22.2587,71.1924
GUJARAT,2005,Tempo/Vans (Private),312,60,372,22.2587,71.1924
GUJARAT,2005,Jeep (Government),29,7,36,22.2587,71.1924
GUJARAT,2005,Jeep (Private),474,104,578,22.2587,71.1924
GUJARAT,2005,Car (Government),17,6,23,22.2587,71.1924
GUJARAT,2005,Car (Private),299,54,353,22.2587,71.1924
GUJARAT,2005,Three Wheeler,347,97,444,22.2587,71.1924
GUJARAT,2005,Two Wheeler,778,123,901,22.2587,71.1924
GUJARAT,2005,Bicycle,125,8,133,22.2587,71.1924
GUJARAT,2005,Pedestrian,505,93,598,22.2587,71.1924
GUJARAT,2005,Others (Please Specify),211,33,244,22.2587,71.1924
GUJARAT,2006,Truck/Lorry (Government),6,2,8,22.2587,71.1924
GUJARAT,2006,Truck/Lorry (Private),1088,165,1253,22.2587,71.1924
GUJARAT,2006,Bus (Government),105,35,140,22.2587,71.1924
GUJARAT,2006,Bus (Private),185,77,262,22.2587,71.1924
GUJARAT,2006,Tempo/Vans (Government),5,0,5,22.2587,71.1924
GUJARAT,2006,Tempo/Vans (Private),293,93,386,22.2587,71.1924
GUJARAT,2006,Jeep (Government),20,4,24,22.2587,71.1924
GUJARAT,2006,Jeep (Private),545,150,695,22.2587,71.1924
GUJARAT,2006,Car (Government),7,3,10,22.2587,71.1924
GUJARAT,2006,Car (Private),290,74,364,22.2587,71.1924
GUJARAT,2006,Three Wheeler,362,145,507,22.2587,71.1924
GUJARAT,2006,Two Wheeler,799,151,950,22.2587,71.1924
GUJARAT,2006,Bicycle,132,10,142,22.2587,71.1924
GUJARAT,2006,Pedestrian,393,103,496,22.2587,71.1924
GUJARAT,2006,Others (Please Specify),282,75,357,22.2587,71.1924
GUJARAT,2007,Truck/Lorry (Government),24,10,34,22.2587,71.1924
GUJARAT,2007,Truck/Lorry (Private),1272,237,1509,22.2587,71.1924
GUJARAT,2007,Bus (Government),102,29,131,22.2587,71.1924
GUJARAT,2007,Bus (Private),271,91,362,22.2587,71.1924
GUJARAT,2007,Tempo/Vans (Government),2,0,2,22.2587,71.1924
GUJARAT,2007,Tempo/Vans (Private),384,97,481,22.2587,71.1924
GUJARAT,2007,Jeep (Government),8,2,10,22.2587,71.1924
GUJARAT,2007,Jeep (Private),606,164,770,22.2587,71.1924
GUJARAT,2007,Car (Government),3,1,4,22.2587,71.1924
GUJARAT,2007,Car (Private),332,91,423,22.2587,71.1924
GUJARAT,2007,Three Wheeler,400,88,488,22.2587,71.1924
GUJARAT,2007,Two Wheeler,881,176,1057,22.2587,71.1924
GUJARAT,2007,Bicycle,150,4,154,22.2587,71.1924
GUJARAT,2007,Pedestrian,457,83,540,22.2587,71.1924
GUJARAT,2007,Others (Please Specify),280,48,328,22.2587,71.1924
GUJARAT,2008,Truck/Lorry (Government),32,3,35,22.2587,71.1924
GUJARAT,2008,Truck/Lorry (Private),1229,192,1421,22.2587,71.1924
GUJARAT,2008,Bus (Government),136,67,203,22.2587,71.1924
GUJARAT,2008,Bus (Private),236,52,288,22.2587,71.1924
GUJARAT,2008,Tempo/Vans (Government),1,0,1,22.2587,71.1924
GUJARAT,2008,Tempo/Vans (Private),366,69,435,22.2587,71.1924
GUJARAT,2008,Jeep (Government),3,1,4,22.2587,71.1924
GUJARAT,2008,Jeep (Private),655,141,796,22.2587,71.1924
GUJARAT,2008,Car (Government),4,1,5,22.2587,71.1924
GUJARAT,2008,Car (Private),364,107,471,22.2587,71.1924
GUJARAT,2008,Three Wheeler,391,106,497,22.2587,71.1924
GUJARAT,2008,Two Wheeler,947,155,1102,22.2587,71.1924
GUJARAT,2008,Bicycle,150,11,161,22.2587,71.1924
GUJARAT,2008,Pedestrian,545,95,640,22.2587,71.1924
GUJARAT,2008,Others (Please Specify),277,50,327,22.2587,71.1924
GUJARAT,2009,Truck/Lorry (Government),5,0,5,22.2587,71.1924
GUJARAT,2009,Truck/Lorry (Private),1202,177,1379,22.2587,71.1924
GUJARAT,2009,Bus (Government),76,25,101,22.2587,71.1924
GUJARAT,2009,Bus (Private),237,67,304,22.2587,71.1924
GUJARAT,2009,Tempo/Vans (Government),12,0,12,22.2587,71.1924
GUJARAT,2009,Tempo/Vans (Private),405,78,483,22.2587,71.1924
GUJARAT,2009,Jeep (Government),6,1,7,22.2587,71.1924
GUJARAT,2009,Jeep (Private),712,225,937,22.2587,71.1924
GUJARAT,2009,Car (Government),3,1,4,22.2587,71.1924
GUJARAT,2009,Car (Private),552,103,655,22.2587,71.1924
GUJARAT,2009,Three Wheeler,409,146,555,22.2587,71.1924
GUJARAT,2009,Two Wheeler,1069,191,1260,22.2587,71.1924
GUJARAT,2009,Bicycle,140,15,155,22.2587,71.1924
GUJARAT,2009,Pedestrian,528,99,627,22.2587,71.1924
GUJARAT,2009,Others (Please Specify),351,79,430,22.2587,71.1924
GUJARAT,2010,Truck/Lorry (Government),9,1,10,22.2587,71.1924
GUJARAT,2010,Truck/Lorry (Private),1291,177,1468,22.2587,71.1924
GUJARAT,2010,Bus (Government),90,14,104,22.2587,71.1924
GUJARAT,2010,Bus (Private),310,72,382,22.2587,71.1924
GUJARAT,2010,Tempo/Vans (Government),4,0,4,22.2587,71.1924
GUJARAT,2010,Tempo/Vans (Private),384,84,468,22.2587,71.1924
GUJARAT,2010,Jeep (Government),6,2,8,22.2587,71.1924
GUJARAT,2010,Jeep (Private),642,153,795,22.2587,71.1924
GUJARAT,2010,Car (Government),2,1,3,22.2587,71.1924
GUJARAT,2010,Car (Private),630,107,737,22.2587,71.1924
GUJARAT,2010,Three Wheeler,534,126,660,22.2587,71.1924
GUJARAT,2010,Two Wheeler,1197,206,1403,22.2587,71.1924
GUJARAT,2010,Bicycle,147,16,163,22.2587,71.1924
GUJARAT,2010,Pedestrian,594,97,691,22.2587,71.1924
GUJARAT,2010,Others (Please Specify),413,75,488,22.2587,71.1924
GUJARAT,2011,Truck/Lorry (Government),12,1,13,22.2587,71.1924
GUJARAT,2011,Truck/Lorry (Private),1484,213,1697,22.2587,71.1924
GUJARAT,2011,Bus (Government),142,30,172,22.2587,71.1924
GUJARAT,2011,Bus (Private),353,73,426,22.2587,71.1924
GUJARAT,2011,Tempo/Vans (Government),16,0,16,22.2587,71.1924
GUJARAT,2011,Tempo/Vans (Private),381,90,471,22.2587,71.1924
GUJARAT,2011,Jeep (Government),17,2,19,22.2587,71.1924
GUJARAT,2011,Jeep (Private),642,149,791,22.2587,71.1924
GUJARAT,2011,Car (Government),6,0,6,22.2587,71.1924
GUJARAT,2011,Car (Private),651,159,810,22.2587,71.1924
GUJARAT,2011,Three Wheeler,598,139,737,22.2587,71.1924
GUJARAT,2011,Two Wheeler,1228,239,1467,22.2587,71.1924
GUJARAT,2011,Bicycle,168,15,183,22.2587,71.1924
GUJARAT,2011,Pedestrian,512,113,625,22.2587,71.1924
GUJARAT,2011,Others (Please Specify),470,103,573,22.2587,71.1924
GUJARAT,2012,Truck/Lorry (Government),12,5,17,22.2587,71.1924
GUJARAT,2012,Truck/Lorry (Private),1409,231,1640,22.2587,71.1924
GUJARAT,2012,Bus (Government),79,21,100,22.2587,71.1924
GUJARAT,2012,Bus (Private),329,84,413,22.2587,71.1924
GUJARAT,2012,Tempo/Vans (Government),4,0,4,22.2587,71.1924
GUJARAT,2012,Tempo/Vans (Private),525,91,616,22.2587,71.1924
GUJARAT,2012,Jeep (Government),22,4,26,22.2587,71.1924
GUJARAT,2012,Jeep (Private),620,147,767,22.2587,71.1924
GUJARAT,2012,Car (Government),26,0,26,22.2587,71.1924
GUJARAT,2012,Car (Private),740,147,887,22.2587,71.1924
GUJARAT,2012,Three Wheeler,579,128,707,22.2587,71.1924
GUJARAT,2012,Two Wheeler,1351,200,1551,22.2587,71.1924
GUJARAT,2012,Bicycle,92,8,100,22.2587,71.1924
GUJARAT,2012,Pedestrian,410,83,493,22.2587,71.1924
GUJARAT,2012,Others (Please Specify),441,67,508,22.2587,71.1924
HARYANA,2001,Truck/Lorry (Government),5,0,5,28.45000633,77.01999101
HARYANA,2001,Truck/Lorry (Private),512,46,558,28.45000633,77.01999101
HARYANA,2001,Bus (Government),120,28,148,28.45000633,77.01999101
HARYANA,2001,Bus (Private),72,16,88,28.45000633,77.01999101
HARYANA,2001,Tempo/Vans (Government),22,3,25,28.45000633,77.01999101
HARYANA,2001,Tempo/Vans (Private),89,18,107,28.45000633,77.01999101
HARYANA,2001,Jeep (Government),32,3,35,28.45000633,77.01999101
HARYANA,2001,Jeep (Private),168,26,194,28.45000633,77.01999101
HARYANA,2001,Car (Government),2,2,4,28.45000633,77.01999101
HARYANA,2001,Car (Private),199,47,246,28.45000633,77.01999101
HARYANA,2001,Three Wheeler,86,28,114,28.45000633,77.01999101
HARYANA,2001,Two Wheeler,215,43,258,28.45000633,77.01999101
HARYANA,2001,Bicycle,145,22,167,28.45000633,77.01999101
HARYANA,2001,Pedestrian,270,9,279,28.45000633,77.01999101
HARYANA,2001,Others (Please Specify),288,52,340,28.45000633,77.01999101
HARYANA,2002,Truck/Lorry (Government),5,0,5,28.45000633,77.01999101
HARYANA,2002,Truck/Lorry (Private),506,41,547,28.45000633,77.01999101
HARYANA,2002,Bus (Government),85,22,107,28.45000633,77.01999101
HARYANA,2002,Bus (Private),63,11,74,28.45000633,77.01999101
HARYANA,2002,Tempo/Vans (Government),3,1,4,28.45000633,77.01999101
HARYANA,2002,Tempo/Vans (Private),269,25,294,28.45000633,77.01999101
HARYANA,2002,Jeep (Government),2,2,4,28.45000633,77.01999101
HARYANA,2002,Jeep (Private),181,27,208,28.45000633,77.01999101
HARYANA,2002,Car (Government),1,0,1,28.45000633,77.01999101
HARYANA,2002,Car (Private),137,26,163,28.45000633,77.01999101
HARYANA,2002,Three Wheeler,75,24,99,28.45000633,77.01999101
HARYANA,2002,Two Wheeler,273,58,331,28.45000633,77.01999101
HARYANA,2002,Bicycle,50,8,58,28.45000633,77.01999101
HARYANA,2002,Pedestrian,191,46,237,28.45000633,77.01999101
HARYANA,2002,Others (Please Specify),261,41,302,28.45000633,77.01999101
HARYANA,2003,Truck/Lorry (Government),355,5,360,28.45000633,77.01999101
HARYANA,2003,Truck/Lorry (Private),408,45,453,28.45000633,77.01999101
HARYANA,2003,Bus (Government),115,18,133,28.45000633,77.01999101
HARYANA,2003,Bus (Private),37,9,46,28.45000633,77.01999101
HARYANA,2003,Tempo/Vans (Government),2,0,2,28.45000633,77.01999101
HARYANA,2003,Tempo/Vans (Private),84,19,103,28.45000633,77.01999101
HARYANA,2003,Jeep (Government),1,1,2,28.45000633,77.01999101
HARYANA,2003,Jeep (Private),275,45,320,28.45000633,77.01999101
HARYANA,2003,Car (Government),0,0,0,28.45000633,77.01999101
HARYANA,2003,Car (Private),186,47,233,28.45000633,77.01999101
HARYANA,2003,Three Wheeler,101,20,121,28.45000633,77.01999101
HARYANA,2003,Two Wheeler,356,66,422,28.45000633,77.01999101
HARYANA,2003,Bicycle,87,10,97,28.45000633,77.01999101
HARYANA,2003,Pedestrian,255,34,289,28.45000633,77.01999101
HARYANA,2003,Others (Please Specify),301,31,332,28.45000633,77.01999101
HARYANA,2004,Truck/Lorry (Government),15,0,15,28.45000633,77.01999101
HARYANA,2004,Truck/Lorry (Private),816,87,903,28.45000633,77.01999101
HARYANA,2004,Bus (Government),142,29,171,28.45000633,77.01999101
HARYANA,2004,Bus (Private),74,15,89,28.45000633,77.01999101
HARYANA,2004,Tempo/Vans (Government),12,1,13,28.45000633,77.01999101
HARYANA,2004,Tempo/Vans (Private),185,31,216,28.45000633,77.01999101
HARYANA,2004,Jeep (Government),1,0,1,28.45000633,77.01999101
HARYANA,2004,Jeep (Private),251,52,303,28.45000633,77.01999101
HARYANA,2004,Car (Government),4,0,4,28.45000633,77.01999101
HARYANA,2004,Car (Private),254,43,297,28.45000633,77.01999101
HARYANA,2004,Three Wheeler,93,18,111,28.45000633,77.01999101
HARYANA,2004,Two Wheeler,307,34,341,28.45000633,77.01999101
HARYANA,2004,Bicycle,64,9,73,28.45000633,77.01999101
HARYANA,2004,Pedestrian,254,42,296,28.45000633,77.01999101
HARYANA,2004,Others (Please Specify),392,28,420,28.45000633,77.01999101
HARYANA,2005,Truck/Lorry (Government),138,4,142,28.45000633,77.01999101
HARYANA,2005,Truck/Lorry (Private),432,28,460,28.45000633,77.01999101
HARYANA,2005,Bus (Government),75,20,95,28.45000633,77.01999101
HARYANA,2005,Bus (Private),86,14,100,28.45000633,77.01999101
HARYANA,2005,Tempo/Vans (Government),15,3,18,28.45000633,77.01999101
HARYANA,2005,Tempo/Vans (Private),135,17,152,28.45000633,77.01999101
HARYANA,2005,Jeep (Government),2,1,3,28.45000633,77.01999101
HARYANA,2005,Jeep (Private),247,29,276,28.45000633,77.01999101
HARYANA,2005,Car (Government),8,1,9,28.45000633,77.01999101
HARYANA,2005,Car (Private),290,50,340,28.45000633,77.01999101
HARYANA,2005,Three Wheeler,110,23,133,28.45000633,77.01999101
HARYANA,2005,Two Wheeler,431,54,485,28.45000633,77.01999101
HARYANA,2005,Bicycle,74,4,78,28.45000633,77.01999101
HARYANA,2005,Pedestrian,244,56,300,28.45000633,77.01999101
HARYANA,2005,Others (Please Specify),619,72,691,28.45000633,77.01999101
HARYANA,2006,Truck/Lorry (Government),67,4,71,28.45000633,77.01999101
HARYANA,2006,Truck/Lorry (Private),634,47,681,28.45000633,77.01999101
HARYANA,2006,Bus (Government),113,21,134,28.45000633,77.01999101
HARYANA,2006,Bus (Private),112,25,137,28.45000633,77.01999101
HARYANA,2006,Tempo/Vans (Government),7,5,12,28.45000633,77.01999101
HARYANA,2006,Tempo/Vans (Private),189,47,236,28.45000633,77.01999101
HARYANA,2006,Jeep (Government),8,1,9,28.45000633,77.01999101
HARYANA,2006,Jeep (Private),365,72,437,28.45000633,77.01999101
HARYANA,2006,Car (Government),17,0,17,28.45000633,77.01999101
HARYANA,2006,Car (Private),429,77,506,28.45000633,77.01999101
HARYANA,2006,Three Wheeler,237,46,283,28.45000633,77.01999101
HARYANA,2006,Two Wheeler,626,99,725,28.45000633,77.01999101
HARYANA,2006,Bicycle,174,25,199,28.45000633,77.01999101
HARYANA,2006,Pedestrian,323,27,350,28.45000633,77.01999101
HARYANA,2006,Others (Please Specify),551,72,623,28.45000633,77.01999101
HARYANA,2007,Truck/Lorry (Government),22,2,24,28.45000633,77.01999101
HARYANA,2007,Truck/Lorry (Private),657,40,697,28.45000633,77.01999101
HARYANA,2007,Bus (Government),96,15,111,28.45000633,77.01999101
HARYANA,2007,Bus (Private),130,22,152,28.45000633,77.01999101
HARYANA,2007,Tempo/Vans (Government),6,2,8,28.45000633,77.01999101
HARYANA,2007,Tempo/Vans (Private),252,22,274,28.45000633,77.01999101
HARYANA,2007,Jeep (Government),15,3,18,28.45000633,77.01999101
HARYANA,2007,Jeep (Private),430,41,471,28.45000633,77.01999101
HARYANA,2007,Car (Government),15,6,21,28.45000633,77.01999101
HARYANA,2007,Car (Private),584,68,652,28.45000633,77.01999101
HARYANA,2007,Three Wheeler,230,36,266,28.45000633,77.01999101
HARYANA,2007,Two Wheeler,702,79,781,28.45000633,77.01999101
HARYANA,2007,Bicycle,95,4,99,28.45000633,77.01999101
HARYANA,2007,Pedestrian,356,56,412,28.45000633,77.01999101
HARYANA,2007,Others (Please Specify),349,41,390,28.45000633,77.01999101
HARYANA,2008,Truck/Lorry (Government),0,0,0,28.45000633,77.01999101
HARYANA,2008,Truck/Lorry (Private),831,61,892,28.45000633,77.01999101
HARYANA,2008,Bus (Government),136,23,159,28.45000633,77.01999101
HARYANA,2008,Bus (Private),120,26,146,28.45000633,77.01999101
HARYANA,2008,Tempo/Vans (Government),0,0,0,28.45000633,77.01999101
HARYANA,2008,Tempo/Vans (Private),310,37,347,28.45000633,77.01999101
HARYANA,2008,Jeep (Government),4,3,7,28.45000633,77.01999101
HARYANA,2008,Jeep (Private),419,47,466,28.45000633,77.01999101
HARYANA,2008,Car (Government),0,0,0,28.45000633,77.01999101
HARYANA,2008,Car (Private),586,55,641,28.45000633,77.01999101
HARYANA,2008,Three Wheeler,256,38,294,28.45000633,77.01999101
HARYANA,2008,Two Wheeler,572,76,648,28.45000633,77.01999101
HARYANA,2008,Bicycle,119,5,124,28.45000633,77.01999101
HARYANA,2008,Pedestrian,421,40,461,28.45000633,77.01999101
HARYANA,2008,Others (Please Specify),440,55,495,28.45000633,77.01999101
HARYANA,2009,Truck/Lorry (Government),32,6,38,28.45000633,77.01999101
HARYANA,2009,Truck/Lorry (Private),680,49,729,28.45000633,77.01999101
HARYANA,2009,Bus (Government),191,27,218,28.45000633,77.01999101
HARYANA,2009,Bus (Private),167,22,189,28.45000633,77.01999101
HARYANA,2009,Tempo/Vans (Government),84,7,91,28.45000633,77.01999101
HARYANA,2009,Tempo/Vans (Private),186,22,208,28.45000633,77.01999101
HARYANA,2009,Jeep (Government),6,0,6,28.45000633,77.01999101
HARYANA,2009,Jeep (Private),344,68,412,28.45000633,77.01999101
HARYANA,2009,Car (Government),0,0,0,28.45000633,77.01999101
HARYANA,2009,Car (Private),448,74,522,28.45000633,77.01999101
HARYANA,2009,Three Wheeler,208,44,252,28.45000633,77.01999101
HARYANA,2009,Two Wheeler,743,95,838,28.45000633,77.01999101
HARYANA,2009,Bicycle,109,4,113,28.45000633,77.01999101
HARYANA,2009,Pedestrian,569,90,659,28.45000633,77.01999101
HARYANA,2009,Others (Please Specify),542,49,591,28.45000633,77.01999101
HARYANA,2010,Truck/Lorry (Government),38,0,38,28.45000633,77.01999101
HARYANA,2010,Truck/Lorry (Private),623,61,684,28.45000633,77.01999101
HARYANA,2010,Bus (Government),94,17,111,28.45000633,77.01999101
HARYANA,2010,Bus (Private),268,26,294,28.45000633,77.01999101
HARYANA,2010,Tempo/Vans (Government),4,0,4,28.45000633,77.01999101
HARYANA,2010,Tempo/Vans (Private),336,46,382,28.45000633,77.01999101
HARYANA,2010,Jeep (Government),2,0,2,28.45000633,77.01999101
HARYANA,2010,Jeep (Private),334,68,402,28.45000633,77.01999101
HARYANA,2010,Car (Government),20,2,22,28.45000633,77.01999101
HARYANA,2010,Car (Private),468,87,555,28.45000633,77.01999101
HARYANA,2010,Three Wheeler,169,37,206,28.45000633,77.01999101
HARYANA,2010,Two Wheeler,630,99,729,28.45000633,77.01999101
HARYANA,2010,Bicycle,109,11,120,28.45000633,77.01999101
HARYANA,2010,Pedestrian,534,70,604,28.45000633,77.01999101
HARYANA,2010,Others (Please Specify),722,131,853,28.45000633,77.01999101
HARYANA,2011,Truck/Lorry (Government),42,2,44,28.45000633,77.01999101
HARYANA,2011,Truck/Lorry (Private),623,62,685,28.45000633,77.01999101
HARYANA,2011,Bus (Government),95,18,113,28.45000633,77.01999101
HARYANA,2011,Bus (Private),105,20,125,28.45000633,77.01999101
HARYANA,2011,Tempo/Vans (Government),2,0,2,28.45000633,77.01999101
HARYANA,2011,Tempo/Vans (Private),232,49,281,28.45000633,77.01999101
HARYANA,2011,Jeep (Government),4,1,5,28.45000633,77.01999101
HARYANA,2011,Jeep (Private),372,43,415,28.45000633,77.01999101
HARYANA,2011,Car (Government),18,1,19,28.45000633,77.01999101
HARYANA,2011,Car (Private),478,69,547,28.45000633,77.01999101
HARYANA,2011,Three Wheeler,156,24,180,28.45000633,77.01999101
HARYANA,2011,Two Wheeler,864,61,925,28.45000633,77.01999101
HARYANA,2011,Bicycle,95,1,96,28.45000633,77.01999101
HARYANA,2011,Pedestrian,662,36,698,28.45000633,77.01999101
HARYANA,2011,Others (Please Specify),517,29,546,28.45000633,77.01999101
HARYANA,2012,Truck/Lorry (Government),4,0,4,28.45000633,77.01999101
HARYANA,2012,Truck/Lorry (Private),619,50,669,28.45000633,77.01999101
HARYANA,2012,Bus (Government),103,16,119,28.45000633,77.01999101
HARYANA,2012,Bus (Private),121,27,148,28.45000633,77.01999101
HARYANA,2012,Tempo/Vans (Government),0,0,0,28.45000633,77.01999101
HARYANA,2012,Tempo/Vans (Private),210,32,242,28.45000633,77.01999101
HARYANA,2012,Jeep (Government),4,1,5,28.45000633,77.01999101
HARYANA,2012,Jeep (Private),396,48,444,28.45000633,77.01999101
HARYANA,2012,Car (Government),0,1,1,28.45000633,77.01999101
HARYANA,2012,Car (Private),516,69,585,28.45000633,77.01999101
HARYANA,2012,Three Wheeler,239,46,285,28.45000633,77.01999101
HARYANA,2012,Two Wheeler,805,100,905,28.45000633,77.01999101
HARYANA,2012,Bicycle,100,0,100,28.45000633,77.01999101
HARYANA,2012,Pedestrian,556,46,602,28.45000633,77.01999101
HARYANA,2012,Others (Please Specify),460,29,489,28.45000633,77.01999101
HIMACHAL PRADESH,2001,Truck/Lorry (Government),1,0,1,31.10002545,77.16659704
HIMACHAL PRADESH,2001,Truck/Lorry (Private),159,15,174,31.10002545,77.16659704
HIMACHAL PRADESH,2001,Bus (Government),55,7,62,31.10002545,77.16659704
HIMACHAL PRADESH,2001,Bus (Private),83,23,106,31.10002545,77.16659704
HIMACHAL PRADESH,2001,Tempo/Vans (Government),0,2,2,31.10002545,77.16659704
HIMACHAL PRADESH,2001,Tempo/Vans (Private),70,8,78,31.10002545,77.16659704
HIMACHAL PRADESH,2001,Jeep (Government),0,0,0,31.10002545,77.16659704
HIMACHAL PRADESH,2001,Jeep (Private),78,13,91,31.10002545,77.16659704
HIMACHAL PRADESH,2001,Car (Government),1,0,1,31.10002545,77.16659704
HIMACHAL PRADESH,2001,Car (Private),76,10,86,31.10002545,77.16659704
HIMACHAL PRADESH,2001,Three Wheeler,6,0,6,31.10002545,77.16659704
HIMACHAL PRADESH,2001,Two Wheeler,53,1,54,31.10002545,77.16659704
HIMACHAL PRADESH,2001,Bicycle,2,0,2,31.10002545,77.16659704
HIMACHAL PRADESH,2001,Pedestrian,29,10,39,31.10002545,77.16659704
HIMACHAL PRADESH,2001,Others (Please Specify),56,5,61,31.10002545,77.16659704
HIMACHAL PRADESH,2002,Truck/Lorry (Government),5,0,5,31.10002545,77.16659704
HIMACHAL PRADESH,2002,Truck/Lorry (Private),160,10,170,31.10002545,77.16659704
HIMACHAL PRADESH,2002,Bus (Government),30,5,35,31.10002545,77.16659704
HIMACHAL PRADESH,2002,Bus (Private),122,50,172,31.10002545,77.16659704
HIMACHAL PRADESH,2002,Tempo/Vans (Government),2,0,2,31.10002545,77.16659704
HIMACHAL PRADESH,2002,Tempo/Vans (Private),65,7,72,31.10002545,77.16659704
HIMACHAL PRADESH,2002,Jeep (Government),0,1,1,31.10002545,77.16659704
HIMACHAL PRADESH,2002,Jeep (Private),82,5,87,31.10002545,77.16659704
HIMACHAL PRADESH,2002,Car (Government),0,0,0,31.10002545,77.16659704
HIMACHAL PRADESH,2002,Car (Private),83,12,95,31.10002545,77.16659704
HIMACHAL PRADESH,2002,Three Wheeler,7,1,8,31.10002545,77.16659704
HIMACHAL PRADESH,2002,Two Wheeler,69,7,76,31.10002545,77.16659704
HIMACHAL PRADESH,2002,Bicycle,4,0,4,31.10002545,77.16659704
HIMACHAL PRADESH,2002,Pedestrian,14,1,15,31.10002545,77.16659704
HIMACHAL PRADESH,2002,Others (Please Specify),92,4,96,31.10002545,77.16659704
HIMACHAL PRADESH,2003,Truck/Lorry (Government),4,0,4,31.10002545,77.16659704
HIMACHAL PRADESH,2003,Truck/Lorry (Private),132,6,138,31.10002545,77.16659704
HIMACHAL PRADESH,2003,Bus (Government),68,9,77,31.10002545,77.16659704
HIMACHAL PRADESH,2003,Bus (Private),54,10,64,31.10002545,77.16659704
HIMACHAL PRADESH,2003,Tempo/Vans (Government),0,0,0,31.10002545,77.16659704
HIMACHAL PRADESH,2003,Tempo/Vans (Private),66,25,91,31.10002545,77.16659704
HIMACHAL PRADESH,2003,Jeep (Government),3,0,3,31.10002545,77.16659704
HIMACHAL PRADESH,2003,Jeep (Private),94,14,108,31.10002545,77.16659704
HIMACHAL PRADESH,2003,Car (Government),5,0,5,31.10002545,77.16659704
HIMACHAL PRADESH,2003,Car (Private),88,14,102,31.10002545,77.16659704
HIMACHAL PRADESH,2003,Three Wheeler,7,1,8,31.10002545,77.16659704
HIMACHAL PRADESH,2003,Two Wheeler,70,7,77,31.10002545,77.16659704
HIMACHAL PRADESH,2003,Bicycle,10,0,10,31.10002545,77.16659704
HIMACHAL PRADESH,2003,Pedestrian,41,9,50,31.10002545,77.16659704
HIMACHAL PRADESH,2003,Others (Please Specify),36,4,40,31.10002545,77.16659704
HIMACHAL PRADESH,2004,Truck/Lorry (Government),14,0,14,31.10002545,77.16659704
HIMACHAL PRADESH,2004,Truck/Lorry (Private),132,7,139,31.10002545,77.16659704
HIMACHAL PRADESH,2004,Bus (Government),50,20,70,31.10002545,77.16659704
HIMACHAL PRADESH,2004,Bus (Private),111,41,152,31.10002545,77.16659704
HIMACHAL PRADESH,2004,Tempo/Vans (Government),0,1,1,31.10002545,77.16659704
HIMACHAL PRADESH,2004,Tempo/Vans (Private),94,14,108,31.10002545,77.16659704
HIMACHAL PRADESH,2004,Jeep (Government),0,0,0,31.10002545,77.16659704
HIMACHAL PRADESH,2004,Jeep (Private),96,14,110,31.10002545,77.16659704
HIMACHAL PRADESH,2004,Car (Government),0,0,0,31.10002545,77.16659704
HIMACHAL PRADESH,2004,Car (Private),138,20,158,31.10002545,77.16659704
HIMACHAL PRADESH,2004,Three Wheeler,9,0,9,31.10002545,77.16659704
HIMACHAL PRADESH,2004,Two Wheeler,84,6,90,31.10002545,77.16659704
HIMACHAL PRADESH,2004,Bicycle,4,0,4,31.10002545,77.16659704
HIMACHAL PRADESH,2004,Pedestrian,16,2,18,31.10002545,77.16659704
HIMACHAL PRADESH,2004,Others (Please Specify),55,6,61,31.10002545,77.16659704
HIMACHAL PRADESH,2005,Truck/Lorry (Government),17,0,17,31.10002545,77.16659704
HIMACHAL PRADESH,2005,Truck/Lorry (Private),118,19,137,31.10002545,77.16659704
HIMACHAL PRADESH,2005,Bus (Government),22,5,27,31.10002545,77.16659704
HIMACHAL PRADESH,2005,Bus (Private),90,27,117,31.10002545,77.16659704
HIMACHAL PRADESH,2005,Tempo/Vans (Government),0,2,2,31.10002545,77.16659704
HIMACHAL PRADESH,2005,Tempo/Vans (Private),29,3,32,31.10002545,77.16659704
HIMACHAL PRADESH,2005,Jeep (Government),9,0,9,31.10002545,77.16659704
HIMACHAL PRADESH,2005,Jeep (Private),135,21,156,31.10002545,77.16659704
HIMACHAL PRADESH,2005,Car (Government),7,0,7,31.10002545,77.16659704
HIMACHAL PRADESH,2005,Car (Private),104,22,126,31.10002545,77.16659704
HIMACHAL PRADESH,2005,Three Wheeler,8,1,9,31.10002545,77.16659704
HIMACHAL PRADESH,2005,Two Wheeler,73,10,83,31.10002545,77.16659704
HIMACHAL PRADESH,2005,Bicycle,1,0,1,31.10002545,77.16659704
HIMACHAL PRADESH,2005,Pedestrian,21,3,24,31.10002545,77.16659704
HIMACHAL PRADESH,2005,Others (Please Specify),100,7,107,31.10002545,77.16659704
HIMACHAL PRADESH,2006,Truck/Lorry (Government),6,0,6,31.10002545,77.16659704
HIMACHAL PRADESH,2006,Truck/Lorry (Private),86,9,95,31.10002545,77.16659704
HIMACHAL PRADESH,2006,Bus (Government),50,12,62,31.10002545,77.16659704
HIMACHAL PRADESH,2006,Bus (Private),62,25,87,31.10002545,77.16659704
HIMACHAL PRADESH,2006,Tempo/Vans (Government),2,0,2,31.10002545,77.16659704
HIMACHAL PRADESH,2006,Tempo/Vans (Private),72,4,76,31.10002545,77.16659704
HIMACHAL PRADESH,2006,Jeep (Government),18,6,24,31.10002545,77.16659704
HIMACHAL PRADESH,2006,Jeep (Private),94,18,112,31.10002545,77.16659704
HIMACHAL PRADESH,2006,Car (Government),0,0,0,31.10002545,77.16659704
HIMACHAL PRADESH,2006,Car (Private),125,42,167,31.10002545,77.16659704
HIMACHAL PRADESH,2006,Three Wheeler,17,2,19,31.10002545,77.16659704
HIMACHAL PRADESH,2006,Two Wheeler,81,9,90,31.10002545,77.16659704
HIMACHAL PRADESH,2006,Bicycle,3,0,3,31.10002545,77.16659704
HIMACHAL PRADESH,2006,Pedestrian,13,1,14,31.10002545,77.16659704
HIMACHAL PRADESH,2006,Others (Please Specify),116,17,133,31.10002545,77.16659704
HIMACHAL PRADESH,2007,Truck/Lorry (Government),21,4,25,31.10002545,77.16659704
HIMACHAL PRADESH,2007,Truck/Lorry (Private),133,4,137,31.10002545,77.16659704
HIMACHAL PRADESH,2007,Bus (Government),32,6,38,31.10002545,77.16659704
HIMACHAL PRADESH,2007,Bus (Private),101,31,132,31.10002545,77.16659704
HIMACHAL PRADESH,2007,Tempo/Vans (Government),0,0,0,31.10002545,77.16659704
HIMACHAL PRADESH,2007,Tempo/Vans (Private),38,4,42,31.10002545,77.16659704
HIMACHAL PRADESH,2007,Jeep (Government),14,3,17,31.10002545,77.16659704
HIMACHAL PRADESH,2007,Jeep (Private),139,18,157,31.10002545,77.16659704
HIMACHAL PRADESH,2007,Car (Government),4,0,4,31.10002545,77.16659704
HIMACHAL PRADESH,2007,Car (Private),112,24,136,31.10002545,77.16659704
HIMACHAL PRADESH,2007,Three Wheeler,0,0,0,31.10002545,77.16659704
HIMACHAL PRADESH,2007,Two Wheeler,104,8,112,31.10002545,77.16659704
HIMACHAL PRADESH,2007,Bicycle,3,0,3,31.10002545,77.16659704
HIMACHAL PRADESH,2007,Pedestrian,15,1,16,31.10002545,77.16659704
HIMACHAL PRADESH,2007,Others (Please Specify),165,13,178,31.10002545,77.16659704
HIMACHAL PRADESH,2008,Truck/Lorry (Government),0,0,0,31.10002545,77.16659704
HIMACHAL PRADESH,2008,Truck/Lorry (Private),110,7,117,31.10002545,77.16659704
HIMACHAL PRADESH,2008,Bus (Government),27,5,32,31.10002545,77.16659704
HIMACHAL PRADESH,2008,Bus (Private),88,17,105,31.10002545,77.16659704
HIMACHAL PRADESH,2008,Tempo/Vans (Government),0,0,0,31.10002545,77.16659704
HIMACHAL PRADESH,2008,Tempo/Vans (Private),42,7,49,31.10002545,77.16659704
HIMACHAL PRADESH,2008,Jeep (Government),23,2,25,31.10002545,77.16659704
HIMACHAL PRADESH,2008,Jeep (Private),90,13,103,31.10002545,77.16659704
HIMACHAL PRADESH,2008,Car (Government),0,0,0,31.10002545,77.16659704
HIMACHAL PRADESH,2008,Car (Private),103,13,116,31.10002545,77.16659704
HIMACHAL PRADESH,2008,Three Wheeler,3,1,4,31.10002545,77.16659704
HIMACHAL PRADESH,2008,Two Wheeler,87,7,94,31.10002545,77.16659704
HIMACHAL PRADESH,2008,Bicycle,2,0,2,31.10002545,77.16659704
HIMACHAL PRADESH,2008,Pedestrian,34,9,43,31.10002545,77.16659704
HIMACHAL PRADESH,2008,Others (Please Specify),103,5,108,31.10002545,77.16659704
HIMACHAL PRADESH,2009,Truck/Lorry (Government),1,0,1,31.10002545,77.16659704
HIMACHAL PRADESH,2009,Truck/Lorry (Private),177,11,188,31.10002545,77.16659704
HIMACHAL PRADESH,2009,Bus (Government),24,6,30,31.10002545,77.16659704
HIMACHAL PRADESH,2009,Bus (Private),137,63,200,31.10002545,77.16659704
HIMACHAL PRADESH,2009,Tempo/Vans (Government),2,0,2,31.10002545,77.16659704
HIMACHAL PRADESH,2009,Tempo/Vans (Private),75,13,88,31.10002545,77.16659704
HIMACHAL PRADESH,2009,Jeep (Government),0,0,0,31.10002545,77.16659704
HIMACHAL PRADESH,2009,Jeep (Private),137,20,157,31.10002545,77.16659704
HIMACHAL PRADESH,2009,Car (Government),0,0,0,31.10002545,77.16659704
HIMACHAL PRADESH,2009,Car (Private),152,23,175,31.10002545,77.16659704
HIMACHAL PRADESH,2009,Three Wheeler,2,0,2,31.10002545,77.16659704
HIMACHAL PRADESH,2009,Two Wheeler,108,21,129,31.10002545,77.16659704
HIMACHAL PRADESH,2009,Bicycle,1,0,1,31.10002545,77.16659704
HIMACHAL PRADESH,2009,Pedestrian,22,4,26,31.10002545,77.16659704
HIMACHAL PRADESH,2009,Others (Please Specify),102,11,113,31.10002545,77.16659704
HIMACHAL PRADESH,2010,Truck/Lorry (Government),0,0,0,31.10002545,77.16659704
HIMACHAL PRADESH,2010,Truck/Lorry (Private),185,45,230,31.10002545,77.16659704
HIMACHAL PRADESH,2010,Bus (Government),31,4,35,31.10002545,77.16659704
HIMACHAL PRADESH,2010,Bus (Private),76,15,91,31.10002545,77.16659704
HIMACHAL PRADESH,2010,Tempo/Vans (Government),0,0,0,31.10002545,77.16659704
HIMACHAL PRADESH,2010,Tempo/Vans (Private),96,11,107,31.10002545,77.16659704
HIMACHAL PRADESH,2010,Jeep (Government),2,0,2,31.10002545,77.16659704
HIMACHAL PRADESH,2010,Jeep (Private),80,15,95,31.10002545,77.16659704
HIMACHAL PRADESH,2010,Car (Government),0,0,0,31.10002545,77.16659704
HIMACHAL PRADESH,2010,Car (Private),196,33,229,31.10002545,77.16659704
HIMACHAL PRADESH,2010,Three Wheeler,8,1,9,31.10002545,77.16659704
HIMACHAL PRADESH,2010,Two Wheeler,120,14,134,31.10002545,77.16659704
HIMACHAL PRADESH,2010,Bicycle,0,0,0,31.10002545,77.16659704
HIMACHAL PRADESH,2010,Pedestrian,17,3,20,31.10002545,77.16659704
HIMACHAL PRADESH,2010,Others (Please Specify),131,16,147,31.10002545,77.16659704
HIMACHAL PRADESH,2011,Truck/Lorry (Government),3,0,3,31.10002545,77.16659704
HIMACHAL PRADESH,2011,Truck/Lorry (Private),132,16,148,31.10002545,77.16659704
HIMACHAL PRADESH,2011,Bus (Government),47,10,57,31.10002545,77.16659704
HIMACHAL PRADESH,2011,Bus (Private),60,20,80,31.10002545,77.16659704
HIMACHAL PRADESH,2011,Tempo/Vans (Government),1,0,1,31.10002545,77.16659704
HIMACHAL PRADESH,2011,Tempo/Vans (Private),65,6,71,31.10002545,77.16659704
HIMACHAL PRADESH,2011,Jeep (Government),0,0,0,31.10002545,77.16659704
HIMACHAL PRADESH,2011,Jeep (Private),115,16,131,31.10002545,77.16659704
HIMACHAL PRADESH,2011,Car (Government),0,0,0,31.10002545,77.16659704
HIMACHAL PRADESH,2011,Car (Private),236,43,279,31.10002545,77.16659704
HIMACHAL PRADESH,2011,Three Wheeler,4,4,8,31.10002545,77.16659704
HIMACHAL PRADESH,2011,Two Wheeler,130,17,147,31.10002545,77.16659704
HIMACHAL PRADESH,2011,Bicycle,0,0,0,31.10002545,77.16659704
HIMACHAL PRADESH,2011,Pedestrian,19,4,23,31.10002545,77.16659704
HIMACHAL PRADESH,2011,Others (Please Specify),114,21,135,31.10002545,77.16659704
HIMACHAL PRADESH,2012,Truck/Lorry (Government),20,0,20,31.10002545,77.16659704
HIMACHAL PRADESH,2012,Truck/Lorry (Private),105,10,115,31.10002545,77.16659704
HIMACHAL PRADESH,2012,Bus (Government),63,12,75,31.10002545,77.16659704
HIMACHAL PRADESH,2012,Bus (Private),78,35,113,31.10002545,77.16659704
HIMACHAL PRADESH,2012,Tempo/Vans (Government),1,1,2,31.10002545,77.16659704
HIMACHAL PRADESH,2012,Tempo/Vans (Private),33,3,36,31.10002545,77.16659704
HIMACHAL PRADESH,2012,Jeep (Government),0,0,0,31.10002545,77.16659704
HIMACHAL PRADESH,2012,Jeep (Private),94,20,114,31.10002545,77.16659704
HIMACHAL PRADESH,2012,Car (Government),0,0,0,31.10002545,77.16659704
HIMACHAL PRADESH,2012,Car (Private),272,39,311,31.10002545,77.16659704
HIMACHAL PRADESH,2012,Three Wheeler,8,0,8,31.10002545,77.16659704
HIMACHAL PRADESH,2012,Two Wheeler,157,21,178,31.10002545,77.16659704
HIMACHAL PRADESH,2012,Bicycle,0,0,0,31.10002545,77.16659704
HIMACHAL PRADESH,2012,Pedestrian,15,2,17,31.10002545,77.16659704
HIMACHAL PRADESH,2012,Others (Please Specify),110,10,120,31.10002545,77.16659704
JAMMU & KASHMIR,2001,Truck/Lorry (Government),35,1,36,34.29995933,74.46665849
JAMMU & KASHMIR,2001,Truck/Lorry (Private),154,13,167,34.29995933,74.46665849
JAMMU & KASHMIR,2001,Bus (Government),11,8,19,34.29995933,74.46665849
JAMMU & KASHMIR,2001,Bus (Private),197,46,243,34.29995933,74.46665849
JAMMU & KASHMIR,2001,Tempo/Vans (Government),0,1,1,34.29995933,74.46665849
JAMMU & KASHMIR,2001,Tempo/Vans (Private),90,9,99,34.29995933,74.46665849
JAMMU & KASHMIR,2001,Jeep (Government),6,0,6,34.29995933,74.46665849
JAMMU & KASHMIR,2001,Jeep (Private),28,2,30,34.29995933,74.46665849
JAMMU & KASHMIR,2001,Car (Government),3,3,6,34.29995933,74.46665849
JAMMU & KASHMIR,2001,Car (Private),37,13,50,34.29995933,74.46665849
JAMMU & KASHMIR,2001,Three Wheeler,4,2,6,34.29995933,74.46665849
JAMMU & KASHMIR,2001,Two Wheeler,43,6,49,34.29995933,74.46665849
JAMMU & KASHMIR,2001,Bicycle,31,11,42,34.29995933,74.46665849
JAMMU & KASHMIR,2001,Pedestrian,0,0,0,34.29995933,74.46665849
JAMMU & KASHMIR,2001,Others (Please Specify),158,33,191,34.29995933,74.46665849
JAMMU & KASHMIR,2002,Truck/Lorry (Government),28,1,29,34.29995933,74.46665849
JAMMU & KASHMIR,2002,Truck/Lorry (Private),152,21,173,34.29995933,74.46665849
JAMMU & KASHMIR,2002,Bus (Government),15,7,22,34.29995933,74.46665849
JAMMU & KASHMIR,2002,Bus (Private),136,35,171,34.29995933,74.46665849
JAMMU & KASHMIR,2002,Tempo/Vans (Government),12,0,12,34.29995933,74.46665849
JAMMU & KASHMIR,2002,Tempo/Vans (Private),41,17,58,34.29995933,74.46665849
JAMMU & KASHMIR,2002,Jeep (Government),1,1,2,34.29995933,74.46665849
JAMMU & KASHMIR,2002,Jeep (Private),18,4,22,34.29995933,74.46665849
JAMMU & KASHMIR,2002,Car (Government),0,1,1,34.29995933,74.46665849
JAMMU & KASHMIR,2002,Car (Private),77,17,94,34.29995933,74.46665849
JAMMU & KASHMIR,2002,Three Wheeler,7,4,11,34.29995933,74.46665849
JAMMU & KASHMIR,2002,Two Wheeler,49,6,55,34.29995933,74.46665849
JAMMU & KASHMIR,2002,Bicycle,1,0,1,34.29995933,74.46665849
JAMMU & KASHMIR,2002,Pedestrian,28,6,34,34.29995933,74.46665849
JAMMU & KASHMIR,2002,Others (Please Specify),184,19,203,34.29995933,74.46665849
JAMMU & KASHMIR,2003,Truck/Lorry (Government),35,2,37,34.29995933,74.46665849
JAMMU & KASHMIR,2003,Truck/Lorry (Private),152,15,167,34.29995933,74.46665849
JAMMU & KASHMIR,2003,Bus (Government),5,0,5,34.29995933,74.46665849
JAMMU & KASHMIR,2003,Bus (Private),138,43,181,34.29995933,74.46665849
JAMMU & KASHMIR,2003,Tempo/Vans (Government),4,1,5,34.29995933,74.46665849
JAMMU & KASHMIR,2003,Tempo/Vans (Private),49,9,58,34.29995933,74.46665849
JAMMU & KASHMIR,2003,Jeep (Government),0,0,0,34.29995933,74.46665849
JAMMU & KASHMIR,2003,Jeep (Private),11,4,15,34.29995933,74.46665849
JAMMU & KASHMIR,2003,Car (Government),1,0,1,34.29995933,74.46665849
JAMMU & KASHMIR,2003,Car (Private),32,14,46,34.29995933,74.46665849
JAMMU & KASHMIR,2003,Three Wheeler,4,0,4,34.29995933,74.46665849
JAMMU & KASHMIR,2003,Two Wheeler,64,14,78,34.29995933,74.46665849
JAMMU & KASHMIR,2003,Bicycle,2,0,2,34.29995933,74.46665849
JAMMU & KASHMIR,2003,Pedestrian,40,8,48,34.29995933,74.46665849
JAMMU & KASHMIR,2003,Others (Please Specify),177,31,208,34.29995933,74.46665849
JAMMU & KASHMIR,2004,Truck/Lorry (Government),26,3,29,34.29995933,74.46665849
JAMMU & KASHMIR,2004,Truck/Lorry (Private),132,17,149,34.29995933,74.46665849
JAMMU & KASHMIR,2004,Bus (Government),1,0,1,34.29995933,74.46665849
JAMMU & KASHMIR,2004,Bus (Private),201,63,264,34.29995933,74.46665849
JAMMU & KASHMIR,2004,Tempo/Vans (Government),0,0,0,34.29995933,74.46665849
JAMMU & KASHMIR,2004,Tempo/Vans (Private),59,9,68,34.29995933,74.46665849
JAMMU & KASHMIR,2004,Jeep (Government),8,2,10,34.29995933,74.46665849
JAMMU & KASHMIR,2004,Jeep (Private),28,11,39,34.29995933,74.46665849
JAMMU & KASHMIR,2004,Car (Government),3,0,3,34.29995933,74.46665849
JAMMU & KASHMIR,2004,Car (Private),34,13,47,34.29995933,74.46665849
JAMMU & KASHMIR,2004,Three Wheeler,7,4,11,34.29995933,74.46665849
JAMMU & KASHMIR,2004,Two Wheeler,64,13,77,34.29995933,74.46665849
JAMMU & KASHMIR,2004,Bicycle,6,2,8,34.29995933,74.46665849
JAMMU & KASHMIR,2004,Pedestrian,20,4,24,34.29995933,74.46665849
JAMMU & KASHMIR,2004,Others (Please Specify),225,14,239,34.29995933,74.46665849
JAMMU & KASHMIR,2005,Truck/Lorry (Government),47,1,48,34.29995933,74.46665849
JAMMU & KASHMIR,2005,Truck/Lorry (Private),135,14,149,34.29995933,74.46665849
JAMMU & KASHMIR,2005,Bus (Government),9,0,9,34.29995933,74.46665849
JAMMU & KASHMIR,2005,Bus (Private),194,28,222,34.29995933,74.46665849
JAMMU & KASHMIR,2005,Tempo/Vans (Government),0,0,0,34.29995933,74.46665849
JAMMU & KASHMIR,2005,Tempo/Vans (Private),61,9,70,34.29995933,74.46665849
JAMMU & KASHMIR,2005,Jeep (Government),0,0,0,34.29995933,74.46665849
JAMMU & KASHMIR,2005,Jeep (Private),23,4,27,34.29995933,74.46665849
JAMMU & KASHMIR,2005,Car (Government),6,1,7,34.29995933,74.46665849
JAMMU & KASHMIR,2005,Car (Private),48,16,64,34.29995933,74.46665849
JAMMU & KASHMIR,2005,Three Wheeler,14,2,16,34.29995933,74.46665849
JAMMU & KASHMIR,2005,Two Wheeler,61,8,69,34.29995933,74.46665849
JAMMU & KASHMIR,2005,Bicycle,0,0,0,34.29995933,74.46665849
JAMMU & KASHMIR,2005,Pedestrian,11,6,17,34.29995933,74.46665849
JAMMU & KASHMIR,2005,Others (Please Specify),124,35,159,34.29995933,74.46665849
JAMMU & KASHMIR,2006,Truck/Lorry (Government),19,4,23,34.29995933,74.46665849
JAMMU & KASHMIR,2006,Truck/Lorry (Private),144,29,173,34.29995933,74.46665849
JAMMU & KASHMIR,2006,Bus (Government),21,6,27,34.29995933,74.46665849
JAMMU & KASHMIR,2006,Bus (Private),246,69,315,34.29995933,74.46665849
JAMMU & KASHMIR,2006,Tempo/Vans (Government),1,0,1,34.29995933,74.46665849
JAMMU & KASHMIR,2006,Tempo/Vans (Private),72,7,79,34.29995933,74.46665849
JAMMU & KASHMIR,2006,Jeep (Government),4,1,5,34.29995933,74.46665849
JAMMU & KASHMIR,2006,Jeep (Private),4,2,6,34.29995933,74.46665849
JAMMU & KASHMIR,2006,Car (Government),5,2,7,34.29995933,74.46665849
JAMMU & KASHMIR,2006,Car (Private),86,21,107,34.29995933,74.46665849
JAMMU & KASHMIR,2006,Three Wheeler,35,10,45,34.29995933,74.46665849
JAMMU & KASHMIR,2006,Two Wheeler,77,16,93,34.29995933,74.46665849
JAMMU & KASHMIR,2006,Bicycle,12,1,13,34.29995933,74.46665849
JAMMU & KASHMIR,2006,Pedestrian,23,3,26,34.29995933,74.46665849
JAMMU & KASHMIR,2006,Others (Please Specify),130,42,172,34.29995933,74.46665849
JAMMU & KASHMIR,2007,Truck/Lorry (Government),10,3,13,34.29995933,74.46665849
JAMMU & KASHMIR,2007,Truck/Lorry (Private),133,18,151,34.29995933,74.46665849
JAMMU & KASHMIR,2007,Bus (Government),8,1,9,34.29995933,74.46665849
JAMMU & KASHMIR,2007,Bus (Private),153,49,202,34.29995933,74.46665849
JAMMU & KASHMIR,2007,Tempo/Vans (Government),12,2,14,34.29995933,74.46665849
JAMMU & KASHMIR,2007,Tempo/Vans (Private),78,12,90,34.29995933,74.46665849
JAMMU & KASHMIR,2007,Jeep (Government),2,0,2,34.29995933,74.46665849
JAMMU & KASHMIR,2007,Jeep (Private),14,0,14,34.29995933,74.46665849
JAMMU & KASHMIR,2007,Car (Government),11,0,11,34.29995933,74.46665849
JAMMU & KASHMIR,2007,Car (Private),100,24,124,34.29995933,74.46665849
JAMMU & KASHMIR,2007,Three Wheeler,9,1,10,34.29995933,74.46665849
JAMMU & KASHMIR,2007,Two Wheeler,84,15,99,34.29995933,74.46665849
JAMMU & KASHMIR,2007,Bicycle,1,0,1,34.29995933,74.46665849
JAMMU & KASHMIR,2007,Pedestrian,46,5,51,34.29995933,74.46665849
JAMMU & KASHMIR,2007,Others (Please Specify),135,26,161,34.29995933,74.46665849
JAMMU & KASHMIR,2008,Truck/Lorry (Government),11,0,11,34.29995933,74.46665849
JAMMU & KASHMIR,2008,Truck/Lorry (Private),143,21,164,34.29995933,74.46665849
JAMMU & KASHMIR,2008,Bus (Government),24,5,29,34.29995933,74.46665849
JAMMU & KASHMIR,2008,Bus (Private),106,42,148,34.29995933,74.46665849
JAMMU & KASHMIR,2008,Tempo/Vans (Government),0,0,0,34.29995933,74.46665849
JAMMU & KASHMIR,2008,Tempo/Vans (Private),45,7,52,34.29995933,74.46665849
JAMMU & KASHMIR,2008,Jeep (Government),12,4,16,34.29995933,74.46665849
JAMMU & KASHMIR,2008,Jeep (Private),22,4,26,34.29995933,74.46665849
JAMMU & KASHMIR,2008,Car (Government),6,0,6,34.29995933,74.46665849
JAMMU & KASHMIR,2008,Car (Private),73,22,95,34.29995933,74.46665849
JAMMU & KASHMIR,2008,Three Wheeler,12,1,13,34.29995933,74.46665849
JAMMU & KASHMIR,2008,Two Wheeler,120,25,145,34.29995933,74.46665849
JAMMU & KASHMIR,2008,Bicycle,2,0,2,34.29995933,74.46665849
JAMMU & KASHMIR,2008,Pedestrian,2,3,5,34.29995933,74.46665849
JAMMU & KASHMIR,2008,Others (Please Specify),225,44,269,34.29995933,74.46665849
JAMMU & KASHMIR,2009,Truck/Lorry (Government),4,1,5,34.29995933,74.46665849
JAMMU & KASHMIR,2009,Truck/Lorry (Private),207,17,224,34.29995933,74.46665849
JAMMU & KASHMIR,2009,Bus (Government),12,0,12,34.29995933,74.46665849
JAMMU & KASHMIR,2009,Bus (Private),185,56,241,34.29995933,74.46665849
JAMMU & KASHMIR,2009,Tempo/Vans (Government),0,0,0,34.29995933,74.46665849
JAMMU & KASHMIR,2009,Tempo/Vans (Private),66,17,83,34.29995933,74.46665849
JAMMU & KASHMIR,2009,Jeep (Government),6,1,7,34.29995933,74.46665849
JAMMU & KASHMIR,2009,Jeep (Private),15,11,26,34.29995933,74.46665849
JAMMU & KASHMIR,2009,Car (Government),7,1,8,34.29995933,74.46665849
JAMMU & KASHMIR,2009,Car (Private),100,17,117,34.29995933,74.46665849
JAMMU & KASHMIR,2009,Three Wheeler,23,5,28,34.29995933,74.46665849
JAMMU & KASHMIR,2009,Two Wheeler,118,15,133,34.29995933,74.46665849
JAMMU & KASHMIR,2009,Bicycle,11,5,16,34.29995933,74.46665849
JAMMU & KASHMIR,2009,Pedestrian,47,15,62,34.29995933,74.46665849
JAMMU & KASHMIR,2009,Others (Please Specify),174,35,209,34.29995933,74.46665849
JAMMU & KASHMIR,2010,Truck/Lorry (Government),7,0,7,34.29995933,74.46665849
JAMMU & KASHMIR,2010,Truck/Lorry (Private),187,17,204,34.29995933,74.46665849
JAMMU & KASHMIR,2010,Bus (Government),4,1,5,34.29995933,74.46665849
JAMMU & KASHMIR,2010,Bus (Private),110,24,134,34.29995933,74.46665849
JAMMU & KASHMIR,2010,Tempo/Vans (Government),2,1,3,34.29995933,74.46665849
JAMMU & KASHMIR,2010,Tempo/Vans (Private),53,23,76,34.29995933,74.46665849
JAMMU & KASHMIR,2010,Jeep (Government),2,0,2,34.29995933,74.46665849
JAMMU & KASHMIR,2010,Jeep (Private),11,3,14,34.29995933,74.46665849
JAMMU & KASHMIR,2010,Car (Government),5,2,7,34.29995933,74.46665849
JAMMU & KASHMIR,2010,Car (Private),109,19,128,34.29995933,74.46665849
JAMMU & KASHMIR,2010,Three Wheeler,14,6,20,34.29995933,74.46665849
JAMMU & KASHMIR,2010,Two Wheeler,121,20,141,34.29995933,74.46665849
JAMMU & KASHMIR,2010,Bicycle,5,1,6,34.29995933,74.46665849
JAMMU & KASHMIR,2010,Pedestrian,28,9,37,34.29995933,74.46665849
JAMMU & KASHMIR,2010,Others (Please Specify),211,34,245,34.29995933,74.46665849
JAMMU & KASHMIR,2011,Truck/Lorry (Government),4,0,4,34.29995933,74.46665849
JAMMU & KASHMIR,2011,Truck/Lorry (Private),162,13,175,34.29995933,74.46665849
JAMMU & KASHMIR,2011,Bus (Government),2,0,2,34.29995933,74.46665849
JAMMU & KASHMIR,2011,Bus (Private),146,30,176,34.29995933,74.46665849
JAMMU & KASHMIR,2011,Tempo/Vans (Government),4,0,4,34.29995933,74.46665849
JAMMU & KASHMIR,2011,Tempo/Vans (Private),60,14,74,34.29995933,74.46665849
JAMMU & KASHMIR,2011,Jeep (Government),3,0,3,34.29995933,74.46665849
JAMMU & KASHMIR,2011,Jeep (Private),15,0,15,34.29995933,74.46665849
JAMMU & KASHMIR,2011,Car (Government),4,0,4,34.29995933,74.46665849
JAMMU & KASHMIR,2011,Car (Private),84,23,107,34.29995933,74.46665849
JAMMU & KASHMIR,2011,Three Wheeler,13,1,14,34.29995933,74.46665849
JAMMU & KASHMIR,2011,Two Wheeler,122,24,146,34.29995933,74.46665849
JAMMU & KASHMIR,2011,Bicycle,5,0,5,34.29995933,74.46665849
JAMMU & KASHMIR,2011,Pedestrian,63,11,74,34.29995933,74.46665849
JAMMU & KASHMIR,2011,Others (Please Specify),299,38,337,34.29995933,74.46665849
JAMMU & KASHMIR,2012,Truck/Lorry (Government),8,3,11,34.29995933,74.46665849
JAMMU & KASHMIR,2012,Truck/Lorry (Private),195,22,217,34.29995933,74.46665849
JAMMU & KASHMIR,2012,Bus (Government),21,6,27,34.29995933,74.46665849
JAMMU & KASHMIR,2012,Bus (Private),97,33,130,34.29995933,74.46665849
JAMMU & KASHMIR,2012,Tempo/Vans (Government),6,4,10,34.29995933,74.46665849
JAMMU & KASHMIR,2012,Tempo/Vans (Private),147,24,171,34.29995933,74.46665849
JAMMU & KASHMIR,2012,Jeep (Government),2,2,4,34.29995933,74.46665849
JAMMU & KASHMIR,2012,Jeep (Private),50,10,60,34.29995933,74.46665849
JAMMU & KASHMIR,2012,Car (Government),7,1,8,34.29995933,74.46665849
JAMMU & KASHMIR,2012,Car (Private),143,33,176,34.29995933,74.46665849
JAMMU & KASHMIR,2012,Three Wheeler,8,0,8,34.29995933,74.46665849
JAMMU & KASHMIR,2012,Two Wheeler,143,22,165,34.29995933,74.46665849
JAMMU & KASHMIR,2012,Bicycle,7,4,11,34.29995933,74.46665849
JAMMU & KASHMIR,2012,Pedestrian,47,7,54,34.29995933,74.46665849
JAMMU & KASHMIR,2012,Others (Please Specify),318,56,374,34.29995933,74.46665849
JHARKHAND,2001,Truck/Lorry (Government),0,0,0,23.80039349,86.41998572
JHARKHAND,2001,Truck/Lorry (Private),10,0,10,23.80039349,86.41998572
JHARKHAND,2001,Bus (Government),1,0,1,23.80039349,86.41998572
JHARKHAND,2001,Bus (Private),142,27,169,23.80039349,86.41998572
JHARKHAND,2001,Tempo/Vans (Government),0,0,0,23.80039349,86.41998572
JHARKHAND,2001,Tempo/Vans (Private),9,2,11,23.80039349,86.41998572
JHARKHAND,2001,Jeep (Government),0,0,0,23.80039349,86.41998572
JHARKHAND,2001,Jeep (Private),52,9,61,23.80039349,86.41998572
JHARKHAND,2001,Car (Government),3,3,6,23.80039349,86.41998572
JHARKHAND,2001,Car (Private),19,4,23,23.80039349,86.41998572
JHARKHAND,2001,Three Wheeler,9,0,9,23.80039349,86.41998572
JHARKHAND,2001,Two Wheeler,31,2,33,23.80039349,86.41998572
JHARKHAND,2001,Bicycle,1,0,1,23.80039349,86.41998572
JHARKHAND,2001,Pedestrian,31,12,43,23.80039349,86.41998572
JHARKHAND,2001,Others (Please Specify),132,18,150,23.80039349,86.41998572
JHARKHAND,2002,Truck/Lorry (Government),0,0,0,23.80039349,86.41998572
JHARKHAND,2002,Truck/Lorry (Private),12,0,12,23.80039349,86.41998572
JHARKHAND,2002,Bus (Government),2,0,2,23.80039349,86.41998572
JHARKHAND,2002,Bus (Private),140,40,180,23.80039349,86.41998572
JHARKHAND,2002,Tempo/Vans (Government),0,0,0,23.80039349,86.41998572
JHARKHAND,2002,Tempo/Vans (Private),8,20,28,23.80039349,86.41998572
JHARKHAND,2002,Jeep (Government),0,0,0,23.80039349,86.41998572
JHARKHAND,2002,Jeep (Private),56,20,76,23.80039349,86.41998572
JHARKHAND,2002,Car (Government),4,2,6,23.80039349,86.41998572
JHARKHAND,2002,Car (Private),20,6,26,23.80039349,86.41998572
JHARKHAND,2002,Three Wheeler,10,2,12,23.80039349,86.41998572
JHARKHAND,2002,Two Wheeler,35,4,39,23.80039349,86.41998572
JHARKHAND,2002,Bicycle,2,1,3,23.80039349,86.41998572
JHARKHAND,2002,Pedestrian,25,25,50,23.80039349,86.41998572
JHARKHAND,2002,Others (Please Specify),16,4,20,23.80039349,86.41998572
JHARKHAND,2003,Truck/Lorry (Government),0,0,0,23.80039349,86.41998572
JHARKHAND,2003,Truck/Lorry (Private),14,0,14,23.80039349,86.41998572
JHARKHAND,2003,Bus (Government),3,0,3,23.80039349,86.41998572
JHARKHAND,2003,Bus (Private),140,40,180,23.80039349,86.41998572
JHARKHAND,2003,Tempo/Vans (Government),0,0,0,23.80039349,86.41998572
JHARKHAND,2003,Tempo/Vans (Private),7,20,27,23.80039349,86.41998572
JHARKHAND,2003,Jeep (Government),0,0,0,23.80039349,86.41998572
JHARKHAND,2003,Jeep (Private),51,20,71,23.80039349,86.41998572
JHARKHAND,2003,Car (Government),5,2,7,23.80039349,86.41998572
JHARKHAND,2003,Car (Private),21,6,27,23.80039349,86.41998572
JHARKHAND,2003,Three Wheeler,11,2,13,23.80039349,86.41998572
JHARKHAND,2003,Two Wheeler,36,4,40,23.80039349,86.41998572
JHARKHAND,2003,Bicycle,3,1,4,23.80039349,86.41998572
JHARKHAND,2003,Pedestrian,22,25,47,23.80039349,86.41998572
JHARKHAND,2003,Others (Please Specify),17,4,21,23.80039349,86.41998572
JHARKHAND,2004,Truck/Lorry (Government),0,0,0,23.80039349,86.41998572
JHARKHAND,2004,Truck/Lorry (Private),15,13,28,23.80039349,86.41998572
JHARKHAND,2004,Bus (Government),0,0,0,23.80039349,86.41998572
JHARKHAND,2004,Bus (Private),176,26,202,23.80039349,86.41998572
JHARKHAND,2004,Tempo/Vans (Government),0,0,0,23.80039349,86.41998572
JHARKHAND,2004,Tempo/Vans (Private),31,14,45,23.80039349,86.41998572
JHARKHAND,2004,Jeep (Government),0,0,0,23.80039349,86.41998572
JHARKHAND,2004,Jeep (Private),75,13,88,23.80039349,86.41998572
JHARKHAND,2004,Car (Government),7,2,9,23.80039349,86.41998572
JHARKHAND,2004,Car (Private),28,9,37,23.80039349,86.41998572
JHARKHAND,2004,Three Wheeler,15,4,19,23.80039349,86.41998572
JHARKHAND,2004,Two Wheeler,47,26,73,23.80039349,86.41998572
JHARKHAND,2004,Bicycle,6,4,10,23.80039349,86.41998572
JHARKHAND,2004,Pedestrian,51,27,78,23.80039349,86.41998572
JHARKHAND,2004,Others (Please Specify),21,4,25,23.80039349,86.41998572
JHARKHAND,2005,Truck/Lorry (Government),0,0,0,23.80039349,86.41998572
JHARKHAND,2005,Truck/Lorry (Private),421,46,467,23.80039349,86.41998572
JHARKHAND,2005,Bus (Government),0,0,0,23.80039349,86.41998572
JHARKHAND,2005,Bus (Private),133,25,158,23.80039349,86.41998572
JHARKHAND,2005,Tempo/Vans (Government),0,0,0,23.80039349,86.41998572
JHARKHAND,2005,Tempo/Vans (Private),48,14,62,23.80039349,86.41998572
JHARKHAND,2005,Jeep (Government),0,0,0,23.80039349,86.41998572
JHARKHAND,2005,Jeep (Private),117,12,129,23.80039349,86.41998572
JHARKHAND,2005,Car (Government),0,0,0,23.80039349,86.41998572
JHARKHAND,2005,Car (Private),67,13,80,23.80039349,86.41998572
JHARKHAND,2005,Three Wheeler,36,14,50,23.80039349,86.41998572
JHARKHAND,2005,Two Wheeler,103,18,121,23.80039349,86.41998572
JHARKHAND,2005,Bicycle,36,0,36,23.80039349,86.41998572
JHARKHAND,2005,Pedestrian,74,15,89,23.80039349,86.41998572
JHARKHAND,2005,Others (Please Specify),72,18,90,23.80039349,86.41998572
JHARKHAND,2006,Truck/Lorry (Government),3,0,3,23.80039349,86.41998572
JHARKHAND,2006,Truck/Lorry (Private),328,34,362,23.80039349,86.41998572
JHARKHAND,2006,Bus (Government),1,0,1,23.80039349,86.41998572
JHARKHAND,2006,Bus (Private),180,51,231,23.80039349,86.41998572
JHARKHAND,2006,Tempo/Vans (Government),0,0,0,23.80039349,86.41998572
JHARKHAND,2006,Tempo/Vans (Private),90,18,108,23.80039349,86.41998572
JHARKHAND,2006,Jeep (Government),13,5,18,23.80039349,86.41998572
JHARKHAND,2006,Jeep (Private),132,28,160,23.80039349,86.41998572
JHARKHAND,2006,Car (Government),5,0,5,23.80039349,86.41998572
JHARKHAND,2006,Car (Private),70,8,78,23.80039349,86.41998572
JHARKHAND,2006,Three Wheeler,44,4,48,23.80039349,86.41998572
JHARKHAND,2006,Two Wheeler,369,37,406,23.80039349,86.41998572
JHARKHAND,2006,Bicycle,36,4,40,23.80039349,86.41998572
JHARKHAND,2006,Pedestrian,95,26,121,23.80039349,86.41998572
JHARKHAND,2006,Others (Please Specify),52,34,86,23.80039349,86.41998572
JHARKHAND,2007,Truck/Lorry (Government),16,3,19,23.80039349,86.41998572
JHARKHAND,2007,Truck/Lorry (Private),308,47,355,23.80039349,86.41998572
JHARKHAND,2007,Bus (Government),6,1,7,23.80039349,86.41998572
JHARKHAND,2007,Bus (Private),211,25,236,23.80039349,86.41998572
JHARKHAND,2007,Tempo/Vans (Government),3,0,3,23.80039349,86.41998572
JHARKHAND,2007,Tempo/Vans (Private),112,15,127,23.80039349,86.41998572
JHARKHAND,2007,Jeep (Government),8,1,9,23.80039349,86.41998572
JHARKHAND,2007,Jeep (Private),205,32,237,23.80039349,86.41998572
JHARKHAND,2007,Car (Government),0,0,0,23.80039349,86.41998572
JHARKHAND,2007,Car (Private),97,20,117,23.80039349,86.41998572
JHARKHAND,2007,Three Wheeler,85,10,95,23.80039349,86.41998572
JHARKHAND,2007,Two Wheeler,232,30,262,23.80039349,86.41998572
JHARKHAND,2007,Bicycle,40,0,40,23.80039349,86.41998572
JHARKHAND,2007,Pedestrian,94,18,112,23.80039349,86.41998572
JHARKHAND,2007,Others (Please Specify),130,11,141,23.80039349,86.41998572
JHARKHAND,2008,Truck/Lorry (Government),24,1,25,23.80039349,86.41998572
JHARKHAND,2008,Truck/Lorry (Private),416,45,461,23.80039349,86.41998572
JHARKHAND,2008,Bus (Government),6,0,6,23.80039349,86.41998572
JHARKHAND,2008,Bus (Private),140,25,165,23.80039349,86.41998572
JHARKHAND,2008,Tempo/Vans (Government),8,2,10,23.80039349,86.41998572
JHARKHAND,2008,Tempo/Vans (Private),95,11,106,23.80039349,86.41998572
JHARKHAND,2008,Jeep (Government),14,0,14,23.80039349,86.41998572
JHARKHAND,2008,Jeep (Private),143,24,167,23.80039349,86.41998572
JHARKHAND,2008,Car (Government),12,0,12,23.80039349,86.41998572
JHARKHAND,2008,Car (Private),93,6,99,23.80039349,86.41998572
JHARKHAND,2008,Three Wheeler,57,5,62,23.80039349,86.41998572
JHARKHAND,2008,Two Wheeler,215,22,237,23.80039349,86.41998572
JHARKHAND,2008,Bicycle,55,0,55,23.80039349,86.41998572
JHARKHAND,2008,Pedestrian,89,10,99,23.80039349,86.41998572
JHARKHAND,2008,Others (Please Specify),49,7,56,23.80039349,86.41998572
JHARKHAND,2009,Truck/Lorry (Government),89,2,91,23.80039349,86.41998572
JHARKHAND,2009,Truck/Lorry (Private),426,52,478,23.80039349,86.41998572
JHARKHAND,2009,Bus (Government),5,2,7,23.80039349,86.41998572
JHARKHAND,2009,Bus (Private),145,38,183,23.80039349,86.41998572
JHARKHAND,2009,Tempo/Vans (Government),8,0,8,23.80039349,86.41998572
JHARKHAND,2009,Tempo/Vans (Private),99,18,117,23.80039349,86.41998572
JHARKHAND,2009,Jeep (Government),16,1,17,23.80039349,86.41998572
JHARKHAND,2009,Jeep (Private),118,16,134,23.80039349,86.41998572
JHARKHAND,2009,Car (Government),3,0,3,23.80039349,86.41998572
JHARKHAND,2009,Car (Private),102,28,130,23.80039349,86.41998572
JHARKHAND,2009,Three Wheeler,44,7,51,23.80039349,86.41998572
JHARKHAND,2009,Two Wheeler,479,67,546,23.80039349,86.41998572
JHARKHAND,2009,Bicycle,31,0,31,23.80039349,86.41998572
JHARKHAND,2009,Pedestrian,92,8,100,23.80039349,86.41998572
JHARKHAND,2009,Others (Please Specify),98,32,130,23.80039349,86.41998572
JHARKHAND,2010,Truck/Lorry (Government),39,18,57,23.80039349,86.41998572
JHARKHAND,2010,Truck/Lorry (Private),348,67,415,23.80039349,86.41998572
JHARKHAND,2010,Bus (Government),24,1,25,23.80039349,86.41998572
JHARKHAND,2010,Bus (Private),214,59,273,23.80039349,86.41998572
JHARKHAND,2010,Tempo/Vans (Government),36,4,40,23.80039349,86.41998572
JHARKHAND,2010,Tempo/Vans (Private),85,36,121,23.80039349,86.41998572
JHARKHAND,2010,Jeep (Government),10,2,12,23.80039349,86.41998572
JHARKHAND,2010,Jeep (Private),136,30,166,23.80039349,86.41998572
JHARKHAND,2010,Car (Government),4,0,4,23.80039349,86.41998572
JHARKHAND,2010,Car (Private),80,20,100,23.80039349,86.41998572
JHARKHAND,2010,Three Wheeler,77,18,95,23.80039349,86.41998572
JHARKHAND,2010,Two Wheeler,315,81,396,23.80039349,86.41998572
JHARKHAND,2010,Bicycle,113,22,135,23.80039349,86.41998572
JHARKHAND,2010,Pedestrian,87,39,126,23.80039349,86.41998572
JHARKHAND,2010,Others (Please Specify),149,26,175,23.80039349,86.41998572
JHARKHAND,2011,Truck/Lorry (Government),17,0,17,23.80039349,86.41998572
JHARKHAND,2011,Truck/Lorry (Private),313,37,350,23.80039349,86.41998572
JHARKHAND,2011,Bus (Government),0,0,0,23.80039349,86.41998572
JHARKHAND,2011,Bus (Private),167,44,211,23.80039349,86.41998572
JHARKHAND,2011,Tempo/Vans (Government),4,0,4,23.80039349,86.41998572
JHARKHAND,2011,Tempo/Vans (Private),72,16,88,23.80039349,86.41998572
JHARKHAND,2011,Jeep (Government),11,1,12,23.80039349,86.41998572
JHARKHAND,2011,Jeep (Private),111,8,119,23.80039349,86.41998572
JHARKHAND,2011,Car (Government),17,2,19,23.80039349,86.41998572
JHARKHAND,2011,Car (Private),131,21,152,23.80039349,86.41998572
JHARKHAND,2011,Three Wheeler,108,22,130,23.80039349,86.41998572
JHARKHAND,2011,Two Wheeler,378,41,419,23.80039349,86.41998572
JHARKHAND,2011,Bicycle,106,5,111,23.80039349,86.41998572
JHARKHAND,2011,Pedestrian,176,52,228,23.80039349,86.41998572
JHARKHAND,2011,Others (Please Specify),75,118,193,23.80039349,86.41998572
JHARKHAND,2012,Truck/Lorry (Government),0,1,1,23.80039349,86.41998572
JHARKHAND,2012,Truck/Lorry (Private),568,61,629,23.80039349,86.41998572
JHARKHAND,2012,Bus (Government),0,0,0,23.80039349,86.41998572
JHARKHAND,2012,Bus (Private),255,58,313,23.80039349,86.41998572
JHARKHAND,2012,Tempo/Vans (Government),1,0,1,23.80039349,86.41998572
JHARKHAND,2012,Tempo/Vans (Private),96,25,121,23.80039349,86.41998572
JHARKHAND,2012,Jeep (Government),2,0,2,23.80039349,86.41998572
JHARKHAND,2012,Jeep (Private),122,34,156,23.80039349,86.41998572
JHARKHAND,2012,Car (Government),36,5,41,23.80039349,86.41998572
JHARKHAND,2012,Car (Private),121,20,141,23.80039349,86.41998572
JHARKHAND,2012,Three Wheeler,95,18,113,23.80039349,86.41998572
JHARKHAND,2012,Two Wheeler,490,67,557,23.80039349,86.41998572
JHARKHAND,2012,Bicycle,51,8,59,23.80039349,86.41998572
JHARKHAND,2012,Pedestrian,97,30,127,23.80039349,86.41998572
JHARKHAND,2012,Others (Please Specify),216,35,251,23.80039349,86.41998572
KARNATAKA,2001,Truck/Lorry (Government),20,9,29,12.57038129,76.91999711
KARNATAKA,2001,Truck/Lorry (Private),1414,186,1600,12.57038129,76.91999711
KARNATAKA,2001,Bus (Government),287,79,366,12.57038129,76.91999711
KARNATAKA,2001,Bus (Private),357,91,448,12.57038129,76.91999711
KARNATAKA,2001,Tempo/Vans (Government),3,0,3,12.57038129,76.91999711
KARNATAKA,2001,Tempo/Vans (Private),580,119,699,12.57038129,76.91999711
KARNATAKA,2001,Jeep (Government),5,0,5,12.57038129,76.91999711
KARNATAKA,2001,Jeep (Private),230,33,263,12.57038129,76.91999711
KARNATAKA,2001,Car (Government),14,0,14,12.57038129,76.91999711
KARNATAKA,2001,Car (Private),259,53,312,12.57038129,76.91999711
KARNATAKA,2001,Three Wheeler,127,25,152,12.57038129,76.91999711
KARNATAKA,2001,Two Wheeler,841,65,906,12.57038129,76.91999711
KARNATAKA,2001,Bicycle,63,5,68,12.57038129,76.91999711
KARNATAKA,2001,Pedestrian,324,70,394,12.57038129,76.91999711
KARNATAKA,2001,Others (Please Specify),447,89,536,12.57038129,76.91999711
KARNATAKA,2002,Truck/Lorry (Government),25,9,34,12.57038129,76.91999711
KARNATAKA,2002,Truck/Lorry (Private),1294,174,1468,12.57038129,76.91999711
KARNATAKA,2002,Bus (Government),318,61,379,12.57038129,76.91999711
KARNATAKA,2002,Bus (Private),293,68,361,12.57038129,76.91999711
KARNATAKA,2002,Tempo/Vans (Government),26,4,30,12.57038129,76.91999711
KARNATAKA,2002,Tempo/Vans (Private),524,91,615,12.57038129,76.91999711
KARNATAKA,2002,Jeep (Government),4,1,5,12.57038129,76.91999711
KARNATAKA,2002,Jeep (Private),196,43,239,12.57038129,76.91999711
KARNATAKA,2002,Car (Government),8,1,9,12.57038129,76.91999711
KARNATAKA,2002,Car (Private),294,78,372,12.57038129,76.91999711
KARNATAKA,2002,Three Wheeler,214,24,238,12.57038129,76.91999711
KARNATAKA,2002,Two Wheeler,966,115,1081,12.57038129,76.91999711
KARNATAKA,2002,Bicycle,114,24,138,12.57038129,76.91999711
KARNATAKA,2002,Pedestrian,455,97,552,12.57038129,76.91999711
KARNATAKA,2002,Others (Please Specify),512,318,830,12.57038129,76.91999711
KARNATAKA,2003,Truck/Lorry (Government),18,1,19,12.57038129,76.91999711
KARNATAKA,2003,Truck/Lorry (Private),1237,167,1404,12.57038129,76.91999711
KARNATAKA,2003,Bus (Government),279,54,333,12.57038129,76.91999711
KARNATAKA,2003,Bus (Private),334,65,399,12.57038129,76.91999711
KARNATAKA,2003,Tempo/Vans (Government),5,2,7,12.57038129,76.91999711
KARNATAKA,2003,Tempo/Vans (Private),589,111,700,12.57038129,76.91999711
KARNATAKA,2003,Jeep (Government),11,6,17,12.57038129,76.91999711
KARNATAKA,2003,Jeep (Private),260,53,313,12.57038129,76.91999711
KARNATAKA,2003,Car (Government),2,1,3,12.57038129,76.91999711
KARNATAKA,2003,Car (Private),308,72,380,12.57038129,76.91999711
KARNATAKA,2003,Three Wheeler,209,46,255,12.57038129,76.91999711
KARNATAKA,2003,Two Wheeler,980,95,1075,12.57038129,76.91999711
KARNATAKA,2003,Bicycle,96,4,100,12.57038129,76.91999711
KARNATAKA,2003,Pedestrian,454,104,558,12.57038129,76.91999711
KARNATAKA,2003,Others (Please Specify),500,109,609,12.57038129,76.91999711
KARNATAKA,2004,Truck/Lorry (Government),6,2,8,12.57038129,76.91999711
KARNATAKA,2004,Truck/Lorry (Private),1197,172,1369,12.57038129,76.91999711
KARNATAKA,2004,Bus (Government),278,85,363,12.57038129,76.91999711
KARNATAKA,2004,Bus (Private),261,73,334,12.57038129,76.91999711
KARNATAKA,2004,Tempo/Vans (Government),9,0,9,12.57038129,76.91999711
KARNATAKA,2004,Tempo/Vans (Private),451,111,562,12.57038129,76.91999711
KARNATAKA,2004,Jeep (Government),9,2,11,12.57038129,76.91999711
KARNATAKA,2004,Jeep (Private),222,55,277,12.57038129,76.91999711
KARNATAKA,2004,Car (Government),4,1,5,12.57038129,76.91999711
KARNATAKA,2004,Car (Private),331,66,397,12.57038129,76.91999711
KARNATAKA,2004,Three Wheeler,204,69,273,12.57038129,76.91999711
KARNATAKA,2004,Two Wheeler,1056,148,1204,12.57038129,76.91999711
KARNATAKA,2004,Bicycle,132,15,147,12.57038129,76.91999711
KARNATAKA,2004,Pedestrian,591,154,745,12.57038129,76.91999711
KARNATAKA,2004,Others (Please Specify),675,102,777,12.57038129,76.91999711
KARNATAKA,2005,Truck/Lorry (Government),15,2,17,12.57038129,76.91999711
KARNATAKA,2005,Truck/Lorry (Private),1127,109,1236,12.57038129,76.91999711
KARNATAKA,2005,Bus (Government),269,53,322,12.57038129,76.91999711
KARNATAKA,2005,Bus (Private),285,71,356,12.57038129,76.91999711
KARNATAKA,2005,Tempo/Vans (Government),17,0,17,12.57038129,76.91999711
KARNATAKA,2005,Tempo/Vans (Private),456,109,565,12.57038129,76.91999711
KARNATAKA,2005,Jeep (Government),5,1,6,12.57038129,76.91999711
KARNATAKA,2005,Jeep (Private),245,47,292,12.57038129,76.91999711
KARNATAKA,2005,Car (Government),10,3,13,12.57038129,76.91999711
KARNATAKA,2005,Car (Private),340,74,414,12.57038129,76.91999711
KARNATAKA,2005,Three Wheeler,215,47,262,12.57038129,76.91999711
KARNATAKA,2005,Two Wheeler,1475,120,1595,12.57038129,76.91999711
KARNATAKA,2005,Bicycle,144,7,151,12.57038129,76.91999711
KARNATAKA,2005,Pedestrian,795,215,1010,12.57038129,76.91999711
KARNATAKA,2005,Others (Please Specify),537,83,620,12.57038129,76.91999711
KARNATAKA,2006,Truck/Lorry (Government),43,6,49,12.57038129,76.91999711
KARNATAKA,2006,Truck/Lorry (Private),1315,150,1465,12.57038129,76.91999711
KARNATAKA,2006,Bus (Government),287,62,349,12.57038129,76.91999711
KARNATAKA,2006,Bus (Private),437,75,512,12.57038129,76.91999711
KARNATAKA,2006,Tempo/Vans (Government),3,0,3,12.57038129,76.91999711
KARNATAKA,2006,Tempo/Vans (Private),486,103,589,12.57038129,76.91999711
KARNATAKA,2006,Jeep (Government),9,0,9,12.57038129,76.91999711
KARNATAKA,2006,Jeep (Private),270,49,319,12.57038129,76.91999711
KARNATAKA,2006,Car (Government),12,2,14,12.57038129,76.91999711
KARNATAKA,2006,Car (Private),380,91,471,12.57038129,76.91999711
KARNATAKA,2006,Three Wheeler,346,93,439,12.57038129,76.91999711
KARNATAKA,2006,Two Wheeler,1467,150,1617,12.57038129,76.91999711
KARNATAKA,2006,Bicycle,137,13,150,12.57038129,76.91999711
KARNATAKA,2006,Pedestrian,694,115,809,12.57038129,76.91999711
KARNATAKA,2006,Others (Please Specify),1004,140,1144,12.57038129,76.91999711
KARNATAKA,2007,Truck/Lorry (Government),18,0,18,12.57038129,76.91999711
KARNATAKA,2007,Truck/Lorry (Private),1543,132,1675,12.57038129,76.91999711
KARNATAKA,2007,Bus (Government),299,63,362,12.57038129,76.91999711
KARNATAKA,2007,Bus (Private),526,81,607,12.57038129,76.91999711
KARNATAKA,2007,Tempo/Vans (Government),11,3,14,12.57038129,76.91999711
KARNATAKA,2007,Tempo/Vans (Private),595,132,727,12.57038129,76.91999711
KARNATAKA,2007,Jeep (Government),10,0,10,12.57038129,76.91999711
KARNATAKA,2007,Jeep (Private),312,46,358,12.57038129,76.91999711
KARNATAKA,2007,Car (Government),11,0,11,12.57038129,76.91999711
KARNATAKA,2007,Car (Private),413,97,510,12.57038129,76.91999711
KARNATAKA,2007,Three Wheeler,401,90,491,12.57038129,76.91999711
KARNATAKA,2007,Two Wheeler,1750,181,1931,12.57038129,76.91999711
KARNATAKA,2007,Bicycle,85,8,93,12.57038129,76.91999711
KARNATAKA,2007,Pedestrian,618,74,692,12.57038129,76.91999711
KARNATAKA,2007,Others (Please Specify),1075,188,1263,12.57038129,76.91999711
KARNATAKA,2008,Truck/Lorry (Government),17,1,18,12.57038129,76.91999711
KARNATAKA,2008,Truck/Lorry (Private),1582,132,1714,12.57038129,76.91999711
KARNATAKA,2008,Bus (Government),406,74,480,12.57038129,76.91999711
KARNATAKA,2008,Bus (Private),464,81,545,12.57038129,76.91999711
KARNATAKA,2008,Tempo/Vans (Government),5,0,5,12.57038129,76.91999711
KARNATAKA,2008,Tempo/Vans (Private),521,100,621,12.57038129,76.91999711
KARNATAKA,2008,Jeep (Government),5,0,5,12.57038129,76.91999711
KARNATAKA,2008,Jeep (Private),327,64,391,12.57038129,76.91999711
KARNATAKA,2008,Car (Government),12,4,16,12.57038129,76.91999711
KARNATAKA,2008,Car (Private),453,103,556,12.57038129,76.91999711
KARNATAKA,2008,Three Wheeler,416,127,543,12.57038129,76.91999711
KARNATAKA,2008,Two Wheeler,1725,200,1925,12.57038129,76.91999711
KARNATAKA,2008,Bicycle,84,9,93,12.57038129,76.91999711
KARNATAKA,2008,Pedestrian,538,53,591,12.57038129,76.91999711
KARNATAKA,2008,Others (Please Specify),1180,131,1311,12.57038129,76.91999711
KARNATAKA,2009,Truck/Lorry (Government),13,0,13,12.57038129,76.91999711
KARNATAKA,2009,Truck/Lorry (Private),1767,117,1884,12.57038129,76.91999711
KARNATAKA,2009,Bus (Government),379,78,457,12.57038129,76.91999711
KARNATAKA,2009,Bus (Private),505,88,593,12.57038129,76.91999711
KARNATAKA,2009,Tempo/Vans (Government),4,2,6,12.57038129,76.91999711
KARNATAKA,2009,Tempo/Vans (Private),459,74,533,12.57038129,76.91999711
KARNATAKA,2009,Jeep (Government),21,0,21,12.57038129,76.91999711
KARNATAKA,2009,Jeep (Private),261,73,334,12.57038129,76.91999711
KARNATAKA,2009,Car (Government),4,0,4,12.57038129,76.91999711
KARNATAKA,2009,Car (Private),714,125,839,12.57038129,76.91999711
KARNATAKA,2009,Three Wheeler,407,105,512,12.57038129,76.91999711
KARNATAKA,2009,Two Wheeler,1592,192,1784,12.57038129,76.91999711
KARNATAKA,2009,Bicycle,56,0,56,12.57038129,76.91999711
KARNATAKA,2009,Pedestrian,425,78,503,12.57038129,76.91999711
KARNATAKA,2009,Others (Please Specify),940,235,1175,12.57038129,76.91999711
KARNATAKA,2010,Truck/Lorry (Government),22,2,24,12.57038129,76.91999711
KARNATAKA,2010,Truck/Lorry (Private),1445,126,1571,12.57038129,76.91999711
KARNATAKA,2010,Bus (Government),313,74,387,12.57038129,76.91999711
KARNATAKA,2010,Bus (Private),368,80,448,12.57038129,76.91999711
KARNATAKA,2010,Tempo/Vans (Government),20,4,24,12.57038129,76.91999711
KARNATAKA,2010,Tempo/Vans (Private),386,95,481,12.57038129,76.91999711
KARNATAKA,2010,Jeep (Government),33,9,42,12.57038129,76.91999711
KARNATAKA,2010,Jeep (Private),267,85,352,12.57038129,76.91999711
KARNATAKA,2010,Car (Government),6,1,7,12.57038129,76.91999711
KARNATAKA,2010,Car (Private),497,115,612,12.57038129,76.91999711
KARNATAKA,2010,Three Wheeler,374,98,472,12.57038129,76.91999711
KARNATAKA,2010,Two Wheeler,2014,233,2247,12.57038129,76.91999711
KARNATAKA,2010,Bicycle,63,2,65,12.57038129,76.91999711
KARNATAKA,2010,Pedestrian,742,203,945,12.57038129,76.91999711
KARNATAKA,2010,Others (Please Specify),1675,222,1897,12.57038129,76.91999711
KARNATAKA,2011,Truck/Lorry (Government),11,0,11,12.57038129,76.91999711
KARNATAKA,2011,Truck/Lorry (Private),1278,124,1402,12.57038129,76.91999711
KARNATAKA,2011,Bus (Government),301,62,363,12.57038129,76.91999711
KARNATAKA,2011,Bus (Private),335,69,404,12.57038129,76.91999711
KARNATAKA,2011,Tempo/Vans (Government),17,2,19,12.57038129,76.91999711
KARNATAKA,2011,Tempo/Vans (Private),374,88,462,12.57038129,76.91999711
KARNATAKA,2011,Jeep (Government),12,2,14,12.57038129,76.91999711
KARNATAKA,2011,Jeep (Private),270,47,317,12.57038129,76.91999711
KARNATAKA,2011,Car (Government),8,5,13,12.57038129,76.91999711
KARNATAKA,2011,Car (Private),586,103,689,12.57038129,76.91999711
KARNATAKA,2011,Three Wheeler,324,85,409,12.57038129,76.91999711
KARNATAKA,2011,Two Wheeler,2119,213,2332,12.57038129,76.91999711
KARNATAKA,2011,Bicycle,68,2,70,12.57038129,76.91999711
KARNATAKA,2011,Pedestrian,666,171,837,12.57038129,76.91999711
KARNATAKA,2011,Others (Please Specify),1387,229,1616,12.57038129,76.91999711
KARNATAKA,2012,Truck/Lorry (Government),15,2,17,12.57038129,76.91999711
KARNATAKA,2012,Truck/Lorry (Private),1260,125,1385,12.57038129,76.91999711
KARNATAKA,2012,Bus (Government),343,86,429,12.57038129,76.91999711
KARNATAKA,2012,Bus (Private),473,82,555,12.57038129,76.91999711
KARNATAKA,2012,Tempo/Vans (Government),11,9,20,12.57038129,76.91999711
KARNATAKA,2012,Tempo/Vans (Private),502,109,611,12.57038129,76.91999711
KARNATAKA,2012,Jeep (Government),12,5,17,12.57038129,76.91999711
KARNATAKA,2012,Jeep (Private),276,65,341,12.57038129,76.91999711
KARNATAKA,2012,Car (Government),12,1,13,12.57038129,76.91999711
KARNATAKA,2012,Car (Private),727,133,860,12.57038129,76.91999711
KARNATAKA,2012,Three Wheeler,351,120,471,12.57038129,76.91999711
KARNATAKA,2012,Two Wheeler,2225,336,2561,12.57038129,76.91999711
KARNATAKA,2012,Bicycle,68,2,70,12.57038129,76.91999711
KARNATAKA,2012,Pedestrian,391,119,510,12.57038129,76.91999711
KARNATAKA,2012,Others (Please Specify),1401,187,1588,12.57038129,76.91999711
KERALA,2001,Truck/Lorry (Government),2,0,2,8.900372741,76.56999263
KERALA,2001,Truck/Lorry (Private),159,15,174,8.900372741,76.56999263
KERALA,2001,Bus (Government),99,12,111,8.900372741,76.56999263
KERALA,2001,Bus (Private),280,85,365,8.900372741,76.56999263
KERALA,2001,Tempo/Vans (Government),2,0,2,8.900372741,76.56999263
KERALA,2001,Tempo/Vans (Private),73,9,82,8.900372741,76.56999263
KERALA,2001,Jeep (Government),9,2,11,8.900372741,76.56999263
KERALA,2001,Jeep (Private),170,41,211,8.900372741,76.56999263
KERALA,2001,Car (Government),14,3,17,8.900372741,76.56999263
KERALA,2001,Car (Private),170,38,208,8.900372741,76.56999263
KERALA,2001,Three Wheeler,154,40,194,8.900372741,76.56999263
KERALA,2001,Two Wheeler,530,66,596,8.900372741,76.56999263
KERALA,2001,Bicycle,68,0,68,8.900372741,76.56999263
KERALA,2001,Pedestrian,479,128,607,8.900372741,76.56999263
KERALA,2001,Others (Please Specify),50,9,59,8.900372741,76.56999263
KERALA,2002,Truck/Lorry (Government),5,0,5,8.900372741,76.56999263
KERALA,2002,Truck/Lorry (Private),202,21,223,8.900372741,76.56999263
KERALA,2002,Bus (Government),71,12,83,8.900372741,76.56999263
KERALA,2002,Bus (Private),164,44,208,8.900372741,76.56999263
KERALA,2002,Tempo/Vans (Government),2,0,2,8.900372741,76.56999263
KERALA,2002,Tempo/Vans (Private),82,8,90,8.900372741,76.56999263
KERALA,2002,Jeep (Government),8,0,8,8.900372741,76.56999263
KERALA,2002,Jeep (Private),137,32,169,8.900372741,76.56999263
KERALA,2002,Car (Government),4,1,5,8.900372741,76.56999263
KERALA,2002,Car (Private),184,46,230,8.900372741,76.56999263
KERALA,2002,Three Wheeler,230,39,269,8.900372741,76.56999263
KERALA,2002,Two Wheeler,707,52,759,8.900372741,76.56999263
KERALA,2002,Bicycle,95,3,98,8.900372741,76.56999263
KERALA,2002,Pedestrian,528,126,654,8.900372741,76.56999263
KERALA,2002,Others (Please Specify),57,13,70,8.900372741,76.56999263
KERALA,2003,Truck/Lorry (Government),8,0,8,8.900372741,76.56999263
KERALA,2003,Truck/Lorry (Private),177,9,186,8.900372741,76.56999263
KERALA,2003,Bus (Government),99,17,116,8.900372741,76.56999263
KERALA,2003,Bus (Private),192,35,227,8.900372741,76.56999263
KERALA,2003,Tempo/Vans (Government),3,0,3,8.900372741,76.56999263
KERALA,2003,Tempo/Vans (Private),109,17,126,8.900372741,76.56999263
KERALA,2003,Jeep (Government),7,1,8,8.900372741,76.56999263
KERALA,2003,Jeep (Private),144,43,187,8.900372741,76.56999263
KERALA,2003,Car (Government),2,0,2,8.900372741,76.56999263
KERALA,2003,Car (Private),172,43,215,8.900372741,76.56999263
KERALA,2003,Three Wheeler,153,50,203,8.900372741,76.56999263
KERALA,2003,Two Wheeler,692,71,763,8.900372741,76.56999263
KERALA,2003,Bicycle,79,6,85,8.900372741,76.56999263
KERALA,2003,Pedestrian,562,166,728,8.900372741,76.56999263
KERALA,2003,Others (Please Specify),67,10,77,8.900372741,76.56999263
KERALA,2004,Truck/Lorry (Government),0,3,3,8.900372741,76.56999263
KERALA,2004,Truck/Lorry (Private),257,34,291,8.900372741,76.56999263
KERALA,2004,Bus (Government),72,20,92,8.900372741,76.56999263
KERALA,2004,Bus (Private),151,45,196,8.900372741,76.56999263
KERALA,2004,Tempo/Vans (Government),3,1,4,8.900372741,76.56999263
KERALA,2004,Tempo/Vans (Private),79,14,93,8.900372741,76.56999263
KERALA,2004,Jeep (Government),8,0,8,8.900372741,76.56999263
KERALA,2004,Jeep (Private),112,32,144,8.900372741,76.56999263
KERALA,2004,Car (Government),4,1,5,8.900372741,76.56999263
KERALA,2004,Car (Private),199,43,242,8.900372741,76.56999263
KERALA,2004,Three Wheeler,181,35,216,8.900372741,76.56999263
KERALA,2004,Two Wheeler,757,57,814,8.900372741,76.56999263
KERALA,2004,Bicycle,112,7,119,8.900372741,76.56999263
KERALA,2004,Pedestrian,703,177,880,8.900372741,76.56999263
KERALA,2004,Others (Please Specify),40,7,47,8.900372741,76.56999263
KERALA,2005,Truck/Lorry (Government),1,0,1,8.900372741,76.56999263
KERALA,2005,Truck/Lorry (Private),38,6,44,8.900372741,76.56999263
KERALA,2005,Bus (Government),93,9,102,8.900372741,76.56999263
KERALA,2005,Bus (Private),307,49,356,8.900372741,76.56999263
KERALA,2005,Tempo/Vans (Government),2,0,2,8.900372741,76.56999263
KERALA,2005,Tempo/Vans (Private),93,7,100,8.900372741,76.56999263
KERALA,2005,Jeep (Government),6,3,9,8.900372741,76.56999263
KERALA,2005,Jeep (Private),111,18,129,8.900372741,76.56999263
KERALA,2005,Car (Government),3,2,5,8.900372741,76.56999263
KERALA,2005,Car (Private),262,63,325,8.900372741,76.56999263
KERALA,2005,Three Wheeler,245,48,293,8.900372741,76.56999263
KERALA,2005,Two Wheeler,758,97,855,8.900372741,76.56999263
KERALA,2005,Bicycle,43,3,46,8.900372741,76.56999263
KERALA,2005,Pedestrian,632,178,810,8.900372741,76.56999263
KERALA,2005,Others (Please Specify),79,5,84,8.900372741,76.56999263
KERALA,2006,Truck/Lorry (Government),0,0,0,8.900372741,76.56999263
KERALA,2006,Truck/Lorry (Private),226,5,231,8.900372741,76.56999263
KERALA,2006,Bus (Government),35,6,41,8.900372741,76.56999263
KERALA,2006,Bus (Private),292,49,341,8.900372741,76.56999263
KERALA,2006,Tempo/Vans (Government),0,0,0,8.900372741,76.56999263
KERALA,2006,Tempo/Vans (Private),183,17,200,8.900372741,76.56999263
KERALA,2006,Jeep (Government),1,0,1,8.900372741,76.56999263
KERALA,2006,Jeep (Private),123,17,140,8.900372741,76.56999263
KERALA,2006,Car (Government),3,0,3,8.900372741,76.56999263
KERALA,2006,Car (Private),262,45,307,8.900372741,76.56999263
KERALA,2006,Three Wheeler,241,48,289,8.900372741,76.56999263
KERALA,2006,Two Wheeler,936,97,1033,8.900372741,76.56999263
KERALA,2006,Bicycle,100,2,102,8.900372741,76.56999263
KERALA,2006,Pedestrian,733,150,883,8.900372741,76.56999263
KERALA,2006,Others (Please Specify),46,10,56,8.900372741,76.56999263
KERALA,2007,Truck/Lorry (Government),0,0,0,8.900372741,76.56999263
KERALA,2007,Truck/Lorry (Private),125,8,133,8.900372741,76.56999263
KERALA,2007,Bus (Government),57,21,78,8.900372741,76.56999263
KERALA,2007,Bus (Private),196,50,246,8.900372741,76.56999263
KERALA,2007,Tempo/Vans (Government),11,1,12,8.900372741,76.56999263
KERALA,2007,Tempo/Vans (Private),96,15,111,8.900372741,76.56999263
KERALA,2007,Jeep (Government),7,0,7,8.900372741,76.56999263
KERALA,2007,Jeep (Private),102,34,136,8.900372741,76.56999263
KERALA,2007,Car (Government),4,1,5,8.900372741,76.56999263
KERALA,2007,Car (Private),265,69,334,8.900372741,76.56999263
KERALA,2007,Three Wheeler,210,57,267,8.900372741,76.56999263
KERALA,2007,Two Wheeler,1137,114,1251,8.900372741,76.56999263
KERALA,2007,Bicycle,135,4,139,8.900372741,76.56999263
KERALA,2007,Pedestrian,828,200,1028,8.900372741,76.56999263
KERALA,2007,Others (Please Specify),47,8,55,8.900372741,76.56999263
KERALA,2008,Truck/Lorry (Government),0,0,0,8.900372741,76.56999263
KERALA,2008,Truck/Lorry (Private),43,7,50,8.900372741,76.56999263
KERALA,2008,Bus (Government),22,7,29,8.900372741,76.56999263
KERALA,2008,Bus (Private),97,22,119,8.900372741,76.56999263
KERALA,2008,Tempo/Vans (Government),0,0,0,8.900372741,76.56999263
KERALA,2008,Tempo/Vans (Private),85,14,99,8.900372741,76.56999263
KERALA,2008,Jeep (Government),1,0,1,8.900372741,76.56999263
KERALA,2008,Jeep (Private),79,20,99,8.900372741,76.56999263
KERALA,2008,Car (Government),0,0,0,8.900372741,76.56999263
KERALA,2008,Car (Private),265,70,335,8.900372741,76.56999263
KERALA,2008,Three Wheeler,259,47,306,8.900372741,76.56999263
KERALA,2008,Two Wheeler,1261,140,1401,8.900372741,76.56999263
KERALA,2008,Bicycle,176,4,180,8.900372741,76.56999263
KERALA,2008,Pedestrian,1026,269,1295,8.900372741,76.56999263
KERALA,2008,Others (Please Specify),18,2,20,8.900372741,76.56999263
KERALA,2009,Truck/Lorry (Government),0,0,0,8.900372741,76.56999263
KERALA,2009,Truck/Lorry (Private),91,8,99,8.900372741,76.56999263
KERALA,2009,Bus (Government),34,8,42,8.900372741,76.56999263
KERALA,2009,Bus (Private),91,16,107,8.900372741,76.56999263
KERALA,2009,Tempo/Vans (Government),0,0,0,8.900372741,76.56999263
KERALA,2009,Tempo/Vans (Private),97,2,99,8.900372741,76.56999263
KERALA,2009,Jeep (Government),0,0,0,8.900372741,76.56999263
KERALA,2009,Jeep (Private),74,18,92,8.900372741,76.56999263
KERALA,2009,Car (Government),1,0,1,8.900372741,76.56999263
KERALA,2009,Car (Private),234,60,294,8.900372741,76.56999263
KERALA,2009,Three Wheeler,228,58,286,8.900372741,76.56999263
KERALA,2009,Two Wheeler,1295,148,1443,8.900372741,76.56999263
KERALA,2009,Bicycle,151,1,152,8.900372741,76.56999263
KERALA,2009,Pedestrian,948,253,1201,8.900372741,76.56999263
KERALA,2009,Others (Please Specify),9,0,9,8.900372741,76.56999263
KERALA,2010,Truck/Lorry (Government),0,0,0,8.900372741,76.56999263
KERALA,2010,Truck/Lorry (Private),164,18,182,8.900372741,76.56999263
KERALA,2010,Bus (Government),61,19,80,8.900372741,76.56999263
KERALA,2010,Bus (Private),130,40,170,8.900372741,76.56999263
KERALA,2010,Tempo/Vans (Government),0,0,0,8.900372741,76.56999263
KERALA,2010,Tempo/Vans (Private),77,14,91,8.900372741,76.56999263
KERALA,2010,Jeep (Government),3,0,3,8.900372741,76.56999263
KERALA,2010,Jeep (Private),78,26,104,8.900372741,76.56999263
KERALA,2010,Car (Government),0,0,0,8.900372741,76.56999263
KERALA,2010,Car (Private),279,75,354,8.900372741,76.56999263
KERALA,2010,Three Wheeler,217,65,282,8.900372741,76.56999263
KERALA,2010,Two Wheeler,1280,139,1419,8.900372741,76.56999263
KERALA,2010,Bicycle,136,0,136,8.900372741,76.56999263
KERALA,2010,Pedestrian,851,248,1099,8.900372741,76.56999263
KERALA,2010,Others (Please Specify),22,8,30,8.900372741,76.56999263
KERALA,2011,Truck/Lorry (Government),1,0,1,8.900372741,76.56999263
KERALA,2011,Truck/Lorry (Private),39,12,51,8.900372741,76.56999263
KERALA,2011,Bus (Government),21,9,30,8.900372741,76.56999263
KERALA,2011,Bus (Private),91,30,121,8.900372741,76.56999263
KERALA,2011,Tempo/Vans (Government),0,0,0,8.900372741,76.56999263
KERALA,2011,Tempo/Vans (Private),73,11,84,8.900372741,76.56999263
KERALA,2011,Jeep (Government),2,0,2,8.900372741,76.56999263
KERALA,2011,Jeep (Private),37,18,55,8.900372741,76.56999263
KERALA,2011,Car (Government),0,0,0,8.900372741,76.56999263
KERALA,2011,Car (Private),249,56,305,8.900372741,76.56999263
KERALA,2011,Three Wheeler,179,61,240,8.900372741,76.56999263
KERALA,2011,Two Wheeler,1556,157,1713,8.900372741,76.56999263
KERALA,2011,Bicycle,141,1,142,8.900372741,76.56999263
KERALA,2011,Pedestrian,1082,278,1360,8.900372741,76.56999263
KERALA,2011,Others (Please Specify),37,4,41,8.900372741,76.56999263
KERALA,2012,Truck/Lorry (Government),0,0,0,8.900372741,76.56999263
KERALA,2012,Truck/Lorry (Private),139,17,156,8.900372741,76.56999263
KERALA,2012,Bus (Government),48,10,58,8.900372741,76.56999263
KERALA,2012,Bus (Private),105,20,125,8.900372741,76.56999263
KERALA,2012,Tempo/Vans (Government),0,0,0,8.900372741,76.56999263
KERALA,2012,Tempo/Vans (Private),65,19,84,8.900372741,76.56999263
KERALA,2012,Jeep (Government),4,0,4,8.900372741,76.56999263
KERALA,2012,Jeep (Private),35,8,43,8.900372741,76.56999263
KERALA,2012,Car (Government),5,0,5,8.900372741,76.56999263
KERALA,2012,Car (Private),224,90,314,8.900372741,76.56999263
KERALA,2012,Three Wheeler,249,39,288,8.900372741,76.56999263
KERALA,2012,Two Wheeler,1501,180,1681,8.900372741,76.56999263
KERALA,2012,Bicycle,131,3,134,8.900372741,76.56999263
KERALA,2012,Pedestrian,1047,298,1345,8.900372741,76.56999263
KERALA,2012,Others (Please Specify),42,7,49,8.900372741,76.56999263
MADHYA PRADESH,2001,Truck/Lorry (Government),44,2,46,21.30039105,76.13001949
MADHYA PRADESH,2001,Truck/Lorry (Private),977,205,1182,21.30039105,76.13001949
MADHYA PRADESH,2001,Bus (Government),240,68,308,21.30039105,76.13001949
MADHYA PRADESH,2001,Bus (Private),89,42,131,21.30039105,76.13001949
MADHYA PRADESH,2001,Tempo/Vans (Government),5,2,7,21.30039105,76.13001949
MADHYA PRADESH,2001,Tempo/Vans (Private),93,22,115,21.30039105,76.13001949
MADHYA PRADESH,2001,Jeep (Government),29,2,31,21.30039105,76.13001949
MADHYA PRADESH,2001,Jeep (Private),422,112,534,21.30039105,76.13001949
MADHYA PRADESH,2001,Car (Government),3,0,3,21.30039105,76.13001949
MADHYA PRADESH,2001,Car (Private),95,18,113,21.30039105,76.13001949
MADHYA PRADESH,2001,Three Wheeler,68,19,87,21.30039105,76.13001949
MADHYA PRADESH,2001,Two Wheeler,414,53,467,21.30039105,76.13001949
MADHYA PRADESH,2001,Bicycle,92,22,114,21.30039105,76.13001949
MADHYA PRADESH,2001,Pedestrian,363,92,455,21.30039105,76.13001949
MADHYA PRADESH,2001,Others (Please Specify),380,82,462,21.30039105,76.13001949
MADHYA PRADESH,2002,Truck/Lorry (Government),37,7,44,21.30039105,76.13001949
MADHYA PRADESH,2002,Truck/Lorry (Private),1004,143,1147,21.30039105,76.13001949
MADHYA PRADESH,2002,Bus (Government),172,33,205,21.30039105,76.13001949
MADHYA PRADESH,2002,Bus (Private),239,72,311,21.30039105,76.13001949
MADHYA PRADESH,2002,Tempo/Vans (Government),11,2,13,21.30039105,76.13001949
MADHYA PRADESH,2002,Tempo/Vans (Private),122,29,151,21.30039105,76.13001949
MADHYA PRADESH,2002,Jeep (Government),8,0,8,21.30039105,76.13001949
MADHYA PRADESH,2002,Jeep (Private),457,114,571,21.30039105,76.13001949
MADHYA PRADESH,2002,Car (Government),4,0,4,21.30039105,76.13001949
MADHYA PRADESH,2002,Car (Private),124,20,144,21.30039105,76.13001949
MADHYA PRADESH,2002,Three Wheeler,117,8,125,21.30039105,76.13001949
MADHYA PRADESH,2002,Two Wheeler,582,69,651,21.30039105,76.13001949
MADHYA PRADESH,2002,Bicycle,79,3,82,21.30039105,76.13001949
MADHYA PRADESH,2002,Pedestrian,320,81,401,21.30039105,76.13001949
MADHYA PRADESH,2002,Others (Please Specify),531,93,624,21.30039105,76.13001949
MADHYA PRADESH,2003,Truck/Lorry (Government),12,2,14,21.30039105,76.13001949
MADHYA PRADESH,2003,Truck/Lorry (Private),989,146,1135,21.30039105,76.13001949
MADHYA PRADESH,2003,Bus (Government),3,0,3,21.30039105,76.13001949
MADHYA PRADESH,2003,Bus (Private),403,95,498,21.30039105,76.13001949
MADHYA PRADESH,2003,Tempo/Vans (Government),3,0,3,21.30039105,76.13001949
MADHYA PRADESH,2003,Tempo/Vans (Private),125,28,153,21.30039105,76.13001949
MADHYA PRADESH,2003,Jeep (Government),13,6,19,21.30039105,76.13001949
MADHYA PRADESH,2003,Jeep (Private),449,84,533,21.30039105,76.13001949
MADHYA PRADESH,2003,Car (Government),5,0,5,21.30039105,76.13001949
MADHYA PRADESH,2003,Car (Private),171,28,199,21.30039105,76.13001949
MADHYA PRADESH,2003,Three Wheeler,106,6,112,21.30039105,76.13001949
MADHYA PRADESH,2003,Two Wheeler,634,82,716,21.30039105,76.13001949
MADHYA PRADESH,2003,Bicycle,74,5,79,21.30039105,76.13001949
MADHYA PRADESH,2003,Pedestrian,361,62,423,21.30039105,76.13001949
MADHYA PRADESH,2003,Others (Please Specify),521,99,620,21.30039105,76.13001949
MADHYA PRADESH,2004,Truck/Lorry (Government),12,2,14,21.30039105,76.13001949
MADHYA PRADESH,2004,Truck/Lorry (Private),958,117,1075,21.30039105,76.13001949
MADHYA PRADESH,2004,Bus (Government),140,30,170,21.30039105,76.13001949
MADHYA PRADESH,2004,Bus (Private),253,64,317,21.30039105,76.13001949
MADHYA PRADESH,2004,Tempo/Vans (Government),3,0,3,21.30039105,76.13001949
MADHYA PRADESH,2004,Tempo/Vans (Private),183,31,214,21.30039105,76.13001949
MADHYA PRADESH,2004,Jeep (Government),10,2,12,21.30039105,76.13001949
MADHYA PRADESH,2004,Jeep (Private),491,110,601,21.30039105,76.13001949
MADHYA PRADESH,2004,Car (Government),10,2,12,21.30039105,76.13001949
MADHYA PRADESH,2004,Car (Private),146,45,191,21.30039105,76.13001949
MADHYA PRADESH,2004,Three Wheeler,77,14,91,21.30039105,76.13001949
MADHYA PRADESH,2004,Two Wheeler,664,98,762,21.30039105,76.13001949
MADHYA PRADESH,2004,Bicycle,114,5,119,21.30039105,76.13001949
MADHYA PRADESH,2004,Pedestrian,493,105,598,21.30039105,76.13001949
MADHYA PRADESH,2004,Others (Please Specify),593,144,737,21.30039105,76.13001949
MADHYA PRADESH,2005,Truck/Lorry (Government),8,0,8,21.30039105,76.13001949
MADHYA PRADESH,2005,Truck/Lorry (Private),1146,144,1290,21.30039105,76.13001949
MADHYA PRADESH,2005,Bus (Government),113,23,136,21.30039105,76.13001949
MADHYA PRADESH,2005,Bus (Private),367,81,448,21.30039105,76.13001949
MADHYA PRADESH,2005,Tempo/Vans (Government),1,0,1,21.30039105,76.13001949
MADHYA PRADESH,2005,Tempo/Vans (Private),175,27,202,21.30039105,76.13001949
MADHYA PRADESH,2005,Jeep (Government),8,0,8,21.30039105,76.13001949
MADHYA PRADESH,2005,Jeep (Private),608,105,713,21.30039105,76.13001949
MADHYA PRADESH,2005,Car (Government),0,0,0,21.30039105,76.13001949
MADHYA PRADESH,2005,Car (Private),172,33,205,21.30039105,76.13001949
MADHYA PRADESH,2005,Three Wheeler,90,16,106,21.30039105,76.13001949
MADHYA PRADESH,2005,Two Wheeler,846,81,927,21.30039105,76.13001949
MADHYA PRADESH,2005,Bicycle,97,7,104,21.30039105,76.13001949
MADHYA PRADESH,2005,Pedestrian,435,98,533,21.30039105,76.13001949
MADHYA PRADESH,2005,Others (Please Specify),567,113,680,21.30039105,76.13001949
MADHYA PRADESH,2006,Truck/Lorry (Government),14,1,15,21.30039105,76.13001949
MADHYA PRADESH,2006,Truck/Lorry (Private),1189,146,1335,21.30039105,76.13001949
MADHYA PRADESH,2006,Bus (Government),3,1,4,21.30039105,76.13001949
MADHYA PRADESH,2006,Bus (Private),460,119,579,21.30039105,76.13001949
MADHYA PRADESH,2006,Tempo/Vans (Government),1,0,1,21.30039105,76.13001949
MADHYA PRADESH,2006,Tempo/Vans (Private),128,23,151,21.30039105,76.13001949
MADHYA PRADESH,2006,Jeep (Government),15,3,18,21.30039105,76.13001949
MADHYA PRADESH,2006,Jeep (Private),476,104,580,21.30039105,76.13001949
MADHYA PRADESH,2006,Car (Government),2,0,2,21.30039105,76.13001949
MADHYA PRADESH,2006,Car (Private),312,57,369,21.30039105,76.13001949
MADHYA PRADESH,2006,Three Wheeler,107,18,125,21.30039105,76.13001949
MADHYA PRADESH,2006,Two Wheeler,869,132,1001,21.30039105,76.13001949
MADHYA PRADESH,2006,Bicycle,98,12,110,21.30039105,76.13001949
MADHYA PRADESH,2006,Pedestrian,418,76,494,21.30039105,76.13001949
MADHYA PRADESH,2006,Others (Please Specify),690,124,814,21.30039105,76.13001949
MADHYA PRADESH,2007,Truck/Lorry (Government),4,0,4,21.30039105,76.13001949
MADHYA PRADESH,2007,Truck/Lorry (Private),1405,193,1598,21.30039105,76.13001949
MADHYA PRADESH,2007,Bus (Government),4,1,5,21.30039105,76.13001949
MADHYA PRADESH,2007,Bus (Private),566,129,695,21.30039105,76.13001949
MADHYA PRADESH,2007,Tempo/Vans (Government),5,0,5,21.30039105,76.13001949
MADHYA PRADESH,2007,Tempo/Vans (Private),153,37,190,21.30039105,76.13001949
MADHYA PRADESH,2007,Jeep (Government),23,4,27,21.30039105,76.13001949
MADHYA PRADESH,2007,Jeep (Private),508,112,620,21.30039105,76.13001949
MADHYA PRADESH,2007,Car (Government),2,0,2,21.30039105,76.13001949
MADHYA PRADESH,2007,Car (Private),291,48,339,21.30039105,76.13001949
MADHYA PRADESH,2007,Three Wheeler,137,21,158,21.30039105,76.13001949
MADHYA PRADESH,2007,Two Wheeler,1105,135,1240,21.30039105,76.13001949
MADHYA PRADESH,2007,Bicycle,71,12,83,21.30039105,76.13001949
MADHYA PRADESH,2007,Pedestrian,522,95,617,21.30039105,76.13001949
MADHYA PRADESH,2007,Others (Please Specify),660,103,763,21.30039105,76.13001949
MADHYA PRADESH,2008,Truck/Lorry (Government),16,5,21,21.30039105,76.13001949
MADHYA PRADESH,2008,Truck/Lorry (Private),1199,148,1347,21.30039105,76.13001949
MADHYA PRADESH,2008,Bus (Government),26,5,31,21.30039105,76.13001949
MADHYA PRADESH,2008,Bus (Private),570,128,698,21.30039105,76.13001949
MADHYA PRADESH,2008,Tempo/Vans (Government),11,0,11,21.30039105,76.13001949
MADHYA PRADESH,2008,Tempo/Vans (Private),275,57,332,21.30039105,76.13001949
MADHYA PRADESH,2008,Jeep (Government),11,0,11,21.30039105,76.13001949
MADHYA PRADESH,2008,Jeep (Private),735,124,859,21.30039105,76.13001949
MADHYA PRADESH,2008,Car (Government),14,7,21,21.30039105,76.13001949
MADHYA PRADESH,2008,Car (Private),284,65,349,21.30039105,76.13001949
MADHYA PRADESH,2008,Three Wheeler,175,31,206,21.30039105,76.13001949
MADHYA PRADESH,2008,Two Wheeler,1597,197,1794,21.30039105,76.13001949
MADHYA PRADESH,2008,Bicycle,227,28,255,21.30039105,76.13001949
MADHYA PRADESH,2008,Pedestrian,758,151,909,21.30039105,76.13001949
MADHYA PRADESH,2008,Others (Please Specify),548,122,670,21.30039105,76.13001949
MADHYA PRADESH,2009,Truck/Lorry (Government),1,0,1,21.30039105,76.13001949
MADHYA PRADESH,2009,Truck/Lorry (Private),1195,160,1355,21.30039105,76.13001949
MADHYA PRADESH,2009,Bus (Government),0,0,0,21.30039105,76.13001949
MADHYA PRADESH,2009,Bus (Private),598,141,739,21.30039105,76.13001949
MADHYA PRADESH,2009,Tempo/Vans (Government),3,0,3,21.30039105,76.13001949
MADHYA PRADESH,2009,Tempo/Vans (Private),317,61,378,21.30039105,76.13001949
MADHYA PRADESH,2009,Jeep (Government),13,0,13,21.30039105,76.13001949
MADHYA PRADESH,2009,Jeep (Private),611,131,742,21.30039105,76.13001949
MADHYA PRADESH,2009,Car (Government),2,2,4,21.30039105,76.13001949
MADHYA PRADESH,2009,Car (Private),376,92,468,21.30039105,76.13001949
MADHYA PRADESH,2009,Three Wheeler,99,36,135,21.30039105,76.13001949
MADHYA PRADESH,2009,Two Wheeler,1610,203,1813,21.30039105,76.13001949
MADHYA PRADESH,2009,Bicycle,277,18,295,21.30039105,76.13001949
MADHYA PRADESH,2009,Pedestrian,991,205,1196,21.30039105,76.13001949
MADHYA PRADESH,2009,Others (Please Specify),705,193,898,21.30039105,76.13001949
MADHYA PRADESH,2010,Truck/Lorry (Government),18,1,19,21.30039105,76.13001949
MADHYA PRADESH,2010,Truck/Lorry (Private),1428,182,1610,21.30039105,76.13001949
MADHYA PRADESH,2010,Bus (Government),47,14,61,21.30039105,76.13001949
MADHYA PRADESH,2010,Bus (Private),475,95,570,21.30039105,76.13001949
MADHYA PRADESH,2010,Tempo/Vans (Government),3,1,4,21.30039105,76.13001949
MADHYA PRADESH,2010,Tempo/Vans (Private),225,43,268,21.30039105,76.13001949
MADHYA PRADESH,2010,Jeep (Government),10,4,14,21.30039105,76.13001949
MADHYA PRADESH,2010,Jeep (Private),777,156,933,21.30039105,76.13001949
MADHYA PRADESH,2010,Car (Government),4,0,4,21.30039105,76.13001949
MADHYA PRADESH,2010,Car (Private),499,91,590,21.30039105,76.13001949
MADHYA PRADESH,2010,Three Wheeler,140,20,160,21.30039105,76.13001949
MADHYA PRADESH,2010,Two Wheeler,1949,227,2176,21.30039105,76.13001949
MADHYA PRADESH,2010,Bicycle,138,12,150,21.30039105,76.13001949
MADHYA PRADESH,2010,Pedestrian,800,157,957,21.30039105,76.13001949
MADHYA PRADESH,2010,Others (Please Specify),871,152,1023,21.30039105,76.13001949
MADHYA PRADESH,2011,Truck/Lorry (Government),14,3,17,21.30039105,76.13001949
MADHYA PRADESH,2011,Truck/Lorry (Private),1441,159,1600,21.30039105,76.13001949
MADHYA PRADESH,2011,Bus (Government),24,6,30,21.30039105,76.13001949
MADHYA PRADESH,2011,Bus (Private),533,102,635,21.30039105,76.13001949
MADHYA PRADESH,2011,Tempo/Vans (Government),22,2,24,21.30039105,76.13001949
MADHYA PRADESH,2011,Tempo/Vans (Private),253,59,312,21.30039105,76.13001949
MADHYA PRADESH,2011,Jeep (Government),6,1,7,21.30039105,76.13001949
MADHYA PRADESH,2011,Jeep (Private),650,153,803,21.30039105,76.13001949
MADHYA PRADESH,2011,Car (Government),9,4,13,21.30039105,76.13001949
MADHYA PRADESH,2011,Car (Private),496,92,588,21.30039105,76.13001949
MADHYA PRADESH,2011,Three Wheeler,156,34,190,21.30039105,76.13001949
MADHYA PRADESH,2011,Two Wheeler,1675,246,1921,21.30039105,76.13001949
MADHYA PRADESH,2011,Bicycle,150,18,168,21.30039105,76.13001949
MADHYA PRADESH,2011,Pedestrian,737,201,938,21.30039105,76.13001949
MADHYA PRADESH,2011,Others (Please Specify),862,148,1010,21.30039105,76.13001949
MADHYA PRADESH,2012,Truck/Lorry (Government),15,0,15,21.30039105,76.13001949
MADHYA PRADESH,2012,Truck/Lorry (Private),1337,166,1503,21.30039105,76.13001949
MADHYA PRADESH,2012,Bus (Government),5,1,6,21.30039105,76.13001949
MADHYA PRADESH,2012,Bus (Private),539,120,659,21.30039105,76.13001949
MADHYA PRADESH,2012,Tempo/Vans (Government),3,1,4,21.30039105,76.13001949
MADHYA PRADESH,2012,Tempo/Vans (Private),241,43,284,21.30039105,76.13001949
MADHYA PRADESH,2012,Jeep (Government),8,0,8,21.30039105,76.13001949
MADHYA PRADESH,2012,Jeep (Private),609,140,749,21.30039105,76.13001949
MADHYA PRADESH,2012,Car (Government),5,0,5,21.30039105,76.13001949
MADHYA PRADESH,2012,Car (Private),437,86,523,21.30039105,76.13001949
MADHYA PRADESH,2012,Three Wheeler,139,34,173,21.30039105,76.13001949
MADHYA PRADESH,2012,Two Wheeler,1964,254,2218,21.30039105,76.13001949
MADHYA PRADESH,2012,Bicycle,136,13,149,21.30039105,76.13001949
MADHYA PRADESH,2012,Pedestrian,942,200,1142,21.30039105,76.13001949
MADHYA PRADESH,2012,Others (Please Specify),890,178,1068,21.30039105,76.13001949
MAHARASHTRA,2001,Truck/Lorry (Government),25,3,28,19.25023195,73.16017493
MAHARASHTRA,2001,Truck/Lorry (Private),2142,357,2499,19.25023195,73.16017493
MAHARASHTRA,2001,Bus (Government),337,86,423,19.25023195,73.16017493
MAHARASHTRA,2001,Bus (Private),301,82,383,19.25023195,73.16017493
MAHARASHTRA,2001,Tempo/Vans (Government),39,7,46,19.25023195,73.16017493
MAHARASHTRA,2001,Tempo/Vans (Private),619,138,757,19.25023195,73.16017493
MAHARASHTRA,2001,Jeep (Government),38,5,43,19.25023195,73.16017493
MAHARASHTRA,2001,Jeep (Private),1181,361,1542,19.25023195,73.16017493
MAHARASHTRA,2001,Car (Government),9,5,14,19.25023195,73.16017493
MAHARASHTRA,2001,Car (Private),526,117,643,19.25023195,73.16017493
MAHARASHTRA,2001,Three Wheeler,415,88,503,19.25023195,73.16017493
MAHARASHTRA,2001,Two Wheeler,1498,156,1654,19.25023195,73.16017493
MAHARASHTRA,2001,Bicycle,293,29,322,19.25023195,73.16017493
MAHARASHTRA,2001,Pedestrian,977,268,1245,19.25023195,73.16017493
MAHARASHTRA,2001,Others (Please Specify),286,34,320,19.25023195,73.16017493
MAHARASHTRA,2002,Truck/Lorry (Government),4,0,4,19.25023195,73.16017493
MAHARASHTRA,2002,Truck/Lorry (Private),1996,235,2231,19.25023195,73.16017493
MAHARASHTRA,2002,Bus (Government),316,60,376,19.25023195,73.16017493
MAHARASHTRA,2002,Bus (Private),225,69,294,19.25023195,73.16017493
MAHARASHTRA,2002,Tempo/Vans (Government),21,0,21,19.25023195,73.16017493
MAHARASHTRA,2002,Tempo/Vans (Private),622,137,759,19.25023195,73.16017493
MAHARASHTRA,2002,Jeep (Government),30,5,35,19.25023195,73.16017493
MAHARASHTRA,2002,Jeep (Private),1180,275,1455,19.25023195,73.16017493
MAHARASHTRA,2002,Car (Government),9,4,13,19.25023195,73.16017493
MAHARASHTRA,2002,Car (Private),562,100,662,19.25023195,73.16017493
MAHARASHTRA,2002,Three Wheeler,466,94,560,19.25023195,73.16017493
MAHARASHTRA,2002,Two Wheeler,1658,219,1877,19.25023195,73.16017493
MAHARASHTRA,2002,Bicycle,341,25,366,19.25023195,73.16017493
MAHARASHTRA,2002,Pedestrian,991,211,1202,19.25023195,73.16017493
MAHARASHTRA,2002,Others (Please Specify),358,49,407,19.25023195,73.16017493
MAHARASHTRA,2003,Truck/Lorry (Government),17,2,19,19.25023195,73.16017493
MAHARASHTRA,2003,Truck/Lorry (Private),1870,191,2061,19.25023195,73.16017493
MAHARASHTRA,2003,Bus (Government),292,61,353,19.25023195,73.16017493
MAHARASHTRA,2003,Bus (Private),272,75,347,19.25023195,73.16017493
MAHARASHTRA,2003,Tempo/Vans (Government),12,1,13,19.25023195,73.16017493
MAHARASHTRA,2003,Tempo/Vans (Private),615,97,712,19.25023195,73.16017493
MAHARASHTRA,2003,Jeep (Government),43,3,46,19.25023195,73.16017493
MAHARASHTRA,2003,Jeep (Private),1233,220,1453,19.25023195,73.16017493
MAHARASHTRA,2003,Car (Government),6,0,6,19.25023195,73.16017493
MAHARASHTRA,2003,Car (Private),585,120,705,19.25023195,73.16017493
MAHARASHTRA,2003,Three Wheeler,443,63,506,19.25023195,73.16017493
MAHARASHTRA,2003,Two Wheeler,1893,220,2113,19.25023195,73.16017493
MAHARASHTRA,2003,Bicycle,278,25,303,19.25023195,73.16017493
MAHARASHTRA,2003,Pedestrian,926,228,1154,19.25023195,73.16017493
MAHARASHTRA,2003,Others (Please Specify),387,66,453,19.25023195,73.16017493
MAHARASHTRA,2004,Truck/Lorry (Government),15,0,15,19.25023195,73.16017493
MAHARASHTRA,2004,Truck/Lorry (Private),1933,236,2169,19.25023195,73.16017493
MAHARASHTRA,2004,Bus (Government),249,66,315,19.25023195,73.16017493
MAHARASHTRA,2004,Bus (Private),211,71,282,19.25023195,73.16017493
MAHARASHTRA,2004,Tempo/Vans (Government),26,7,33,19.25023195,73.16017493
MAHARASHTRA,2004,Tempo/Vans (Private),576,90,666,19.25023195,73.16017493
MAHARASHTRA,2004,Jeep (Government),13,0,13,19.25023195,73.16017493
MAHARASHTRA,2004,Jeep (Private),1281,217,1498,19.25023195,73.16017493
MAHARASHTRA,2004,Car (Government),14,6,20,19.25023195,73.16017493
MAHARASHTRA,2004,Car (Private),552,99,651,19.25023195,73.16017493
MAHARASHTRA,2004,Three Wheeler,466,94,560,19.25023195,73.16017493
MAHARASHTRA,2004,Two Wheeler,2157,212,2369,19.25023195,73.16017493
MAHARASHTRA,2004,Bicycle,253,11,264,19.25023195,73.16017493
MAHARASHTRA,2004,Pedestrian,1009,247,1256,19.25023195,73.16017493
MAHARASHTRA,2004,Others (Please Specify),436,58,494,19.25023195,73.16017493
MAHARASHTRA,2005,Truck/Lorry (Government),8,3,11,19.25023195,73.16017493
MAHARASHTRA,2005,Truck/Lorry (Private),2023,271,2294,19.25023195,73.16017493
MAHARASHTRA,2005,Bus (Government),222,53,275,19.25023195,73.16017493
MAHARASHTRA,2005,Bus (Private),198,42,240,19.25023195,73.16017493
MAHARASHTRA,2005,Tempo/Vans (Government),10,1,11,19.25023195,73.16017493
MAHARASHTRA,2005,Tempo/Vans (Private),625,117,742,19.25023195,73.16017493
MAHARASHTRA,2005,Jeep (Government),15,2,17,19.25023195,73.16017493
MAHARASHTRA,2005,Jeep (Private),1220,240,1460,19.25023195,73.16017493
MAHARASHTRA,2005,Car (Government),4,1,5,19.25023195,73.16017493
MAHARASHTRA,2005,Car (Private),551,117,668,19.25023195,73.16017493
MAHARASHTRA,2005,Three Wheeler,481,77,558,19.25023195,73.16017493
MAHARASHTRA,2005,Two Wheeler,2204,235,2439,19.25023195,73.16017493
MAHARASHTRA,2005,Bicycle,223,14,237,19.25023195,73.16017493
MAHARASHTRA,2005,Pedestrian,994,230,1224,19.25023195,73.16017493
MAHARASHTRA,2005,Others (Please Specify),392,40,432,19.25023195,73.16017493
MAHARASHTRA,2006,Truck/Lorry (Government),14,3,17,19.25023195,73.16017493
MAHARASHTRA,2006,Truck/Lorry (Private),2241,272,2513,19.25023195,73.16017493
MAHARASHTRA,2006,Bus (Government),266,77,343,19.25023195,73.16017493
MAHARASHTRA,2006,Bus (Private),242,66,308,19.25023195,73.16017493
MAHARASHTRA,2006,Tempo/Vans (Government),21,2,23,19.25023195,73.16017493
MAHARASHTRA,2006,Tempo/Vans (Private),640,87,727,19.25023195,73.16017493
MAHARASHTRA,2006,Jeep (Government),8,2,10,19.25023195,73.16017493
MAHARASHTRA,2006,Jeep (Private),1187,242,1429,19.25023195,73.16017493
MAHARASHTRA,2006,Car (Government),0,0,0,19.25023195,73.16017493
MAHARASHTRA,2006,Car (Private),745,137,882,19.25023195,73.16017493
MAHARASHTRA,2006,Three Wheeler,468,103,571,19.25023195,73.16017493
MAHARASHTRA,2006,Two Wheeler,2666,277,2943,19.25023195,73.16017493
MAHARASHTRA,2006,Bicycle,275,20,295,19.25023195,73.16017493
MAHARASHTRA,2006,Pedestrian,1248,230,1478,19.25023195,73.16017493
MAHARASHTRA,2006,Others (Please Specify),339,56,395,19.25023195,73.16017493
MAHARASHTRA,2007,Truck/Lorry (Government),32,11,43,19.25023195,73.16017493
MAHARASHTRA,2007,Truck/Lorry (Private),2073,210,2283,19.25023195,73.16017493
MAHARASHTRA,2007,Bus (Government),268,63,331,19.25023195,73.16017493
MAHARASHTRA,2007,Bus (Private),203,30,233,19.25023195,73.16017493
MAHARASHTRA,2007,Tempo/Vans (Government),4,3,7,19.25023195,73.16017493
MAHARASHTRA,2007,Tempo/Vans (Private),687,87,774,19.25023195,73.16017493
MAHARASHTRA,2007,Jeep (Government),19,5,24,19.25023195,73.16017493
MAHARASHTRA,2007,Jeep (Private),1187,238,1425,19.25023195,73.16017493
MAHARASHTRA,2007,Car (Government),0,0,0,19.25023195,73.16017493
MAHARASHTRA,2007,Car (Private),742,143,885,19.25023195,73.16017493
MAHARASHTRA,2007,Three Wheeler,571,151,722,19.25023195,73.16017493
MAHARASHTRA,2007,Two Wheeler,3018,345,3363,19.25023195,73.16017493
MAHARASHTRA,2007,Bicycle,292,20,312,19.25023195,73.16017493
MAHARASHTRA,2007,Pedestrian,1431,317,1748,19.25023195,73.16017493
MAHARASHTRA,2007,Others (Please Specify),405,61,466,19.25023195,73.16017493
MAHARASHTRA,2008,Truck/Lorry (Government),18,2,20,19.25023195,73.16017493
MAHARASHTRA,2008,Truck/Lorry (Private),2145,220,2365,19.25023195,73.16017493
MAHARASHTRA,2008,Bus (Government),239,63,302,19.25023195,73.16017493
MAHARASHTRA,2008,Bus (Private),215,56,271,19.25023195,73.16017493
MAHARASHTRA,2008,Tempo/Vans (Government),8,0,8,19.25023195,73.16017493
MAHARASHTRA,2008,Tempo/Vans (Private),660,104,764,19.25023195,73.16017493
MAHARASHTRA,2008,Jeep (Government),12,1,13,19.25023195,73.16017493
MAHARASHTRA,2008,Jeep (Private),1075,242,1317,19.25023195,73.16017493
MAHARASHTRA,2008,Car (Government),25,10,35,19.25023195,73.16017493
MAHARASHTRA,2008,Car (Private),778,149,927,19.25023195,73.16017493
MAHARASHTRA,2008,Three Wheeler,633,142,775,19.25023195,73.16017493
MAHARASHTRA,2008,Two Wheeler,3152,421,3573,19.25023195,73.16017493
MAHARASHTRA,2008,Bicycle,271,22,293,19.25023195,73.16017493
MAHARASHTRA,2008,Pedestrian,1478,322,1800,19.25023195,73.16017493
MAHARASHTRA,2008,Others (Please Specify),429,65,494,19.25023195,73.16017493
MAHARASHTRA,2009,Truck/Lorry (Government),26,1,27,19.25023195,73.16017493
MAHARASHTRA,2009,Truck/Lorry (Private),2098,238,2336,19.25023195,73.16017493
MAHARASHTRA,2009,Bus (Government),182,51,233,19.25023195,73.16017493
MAHARASHTRA,2009,Bus (Private),184,33,217,19.25023195,73.16017493
MAHARASHTRA,2009,Tempo/Vans (Government),51,13,64,19.25023195,73.16017493
MAHARASHTRA,2009,Tempo/Vans (Private),602,97,699,19.25023195,73.16017493
MAHARASHTRA,2009,Jeep (Government),30,13,43,19.25023195,73.16017493
MAHARASHTRA,2009,Jeep (Private),1090,212,1302,19.25023195,73.16017493
MAHARASHTRA,2009,Car (Government),1,1,2,19.25023195,73.16017493
MAHARASHTRA,2009,Car (Private),795,183,978,19.25023195,73.16017493
MAHARASHTRA,2009,Three Wheeler,615,105,720,19.25023195,73.16017493
MAHARASHTRA,2009,Two Wheeler,3442,376,3818,19.25023195,73.16017493
MAHARASHTRA,2009,Bicycle,263,15,278,19.25023195,73.16017493
MAHARASHTRA,2009,Pedestrian,1428,314,1742,19.25023195,73.16017493
MAHARASHTRA,2009,Others (Please Specify),532,43,575,19.25023195,73.16017493
MAHARASHTRA,2010,Truck/Lorry (Government),28,5,33,19.25023195,73.16017493
MAHARASHTRA,2010,Truck/Lorry (Private),2105,225,2330,19.25023195,73.16017493
MAHARASHTRA,2010,Bus (Government),212,39,251,19.25023195,73.16017493
MAHARASHTRA,2010,Bus (Private),228,53,281,19.25023195,73.16017493
MAHARASHTRA,2010,Tempo/Vans (Government),5,2,7,19.25023195,73.16017493
MAHARASHTRA,2010,Tempo/Vans (Private),655,87,742,19.25023195,73.16017493
MAHARASHTRA,2010,Jeep (Government),17,1,18,19.25023195,73.16017493
MAHARASHTRA,2010,Jeep (Private),1184,211,1395,19.25023195,73.16017493
MAHARASHTRA,2010,Car (Government),4,1,5,19.25023195,73.16017493
MAHARASHTRA,2010,Car (Private),942,186,1128,19.25023195,73.16017493
MAHARASHTRA,2010,Three Wheeler,656,127,783,19.25023195,73.16017493
MAHARASHTRA,2010,Two Wheeler,3856,453,4309,19.25023195,73.16017493
MAHARASHTRA,2010,Bicycle,257,11,268,19.25023195,73.16017493
MAHARASHTRA,2010,Pedestrian,1671,313,1984,19.25023195,73.16017493
MAHARASHTRA,2010,Others (Please Specify),470,59,529,19.25023195,73.16017493
MAHARASHTRA,2011,Truck/Lorry (Government),7,1,8,19.25023195,73.16017493
MAHARASHTRA,2011,Truck/Lorry (Private),1994,253,2247,19.25023195,73.16017493
MAHARASHTRA,2011,Bus (Government),304,56,360,19.25023195,73.16017493
MAHARASHTRA,2011,Bus (Private),258,67,325,19.25023195,73.16017493
MAHARASHTRA,2011,Tempo/Vans (Government),6,1,7,19.25023195,73.16017493
MAHARASHTRA,2011,Tempo/Vans (Private),855,106,961,19.25023195,73.16017493
MAHARASHTRA,2011,Jeep (Government),16,1,17,19.25023195,73.16017493
MAHARASHTRA,2011,Jeep (Private),993,170,1163,19.25023195,73.16017493
MAHARASHTRA,2011,Car (Government),6,0,6,19.25023195,73.16017493
MAHARASHTRA,2011,Car (Private),1018,197,1215,19.25023195,73.16017493
MAHARASHTRA,2011,Three Wheeler,570,152,722,19.25023195,73.16017493
MAHARASHTRA,2011,Two Wheeler,3598,471,4069,19.25023195,73.16017493
MAHARASHTRA,2011,Bicycle,177,12,189,19.25023195,73.16017493
MAHARASHTRA,2011,Pedestrian,1284,283,1567,19.25023195,73.16017493
MAHARASHTRA,2011,Others (Please Specify),739,85,824,19.25023195,73.16017493
MAHARASHTRA,2012,Truck/Lorry (Government),12,1,13,19.25023195,73.16017493
MAHARASHTRA,2012,Truck/Lorry (Private),2054,239,2293,19.25023195,73.16017493
MAHARASHTRA,2012,Bus (Government),236,57,293,19.25023195,73.16017493
MAHARASHTRA,2012,Bus (Private),212,40,252,19.25023195,73.16017493
MAHARASHTRA,2012,Tempo/Vans (Government),3,1,4,19.25023195,73.16017493
MAHARASHTRA,2012,Tempo/Vans (Private),819,109,928,19.25023195,73.16017493
MAHARASHTRA,2012,Jeep (Government),7,0,7,19.25023195,73.16017493
MAHARASHTRA,2012,Jeep (Private),1011,153,1164,19.25023195,73.16017493
MAHARASHTRA,2012,Car (Government),4,2,6,19.25023195,73.16017493
MAHARASHTRA,2012,Car (Private),1018,222,1240,19.25023195,73.16017493
MAHARASHTRA,2012,Three Wheeler,535,98,633,19.25023195,73.16017493
MAHARASHTRA,2012,Two Wheeler,4022,462,4484,19.25023195,73.16017493
MAHARASHTRA,2012,Bicycle,212,12,224,19.25023195,73.16017493
MAHARASHTRA,2012,Pedestrian,1377,327,1704,19.25023195,73.16017493
MAHARASHTRA,2012,Others (Please Specify),598,93,691,19.25023195,73.16017493
MANIPUR,2001,Truck/Lorry (Government),4,0,4,24.79997072,93.95001705
MANIPUR,2001,Truck/Lorry (Private),28,3,31,24.79997072,93.95001705
MANIPUR,2001,Bus (Government),0,0,0,24.79997072,93.95001705
MANIPUR,2001,Bus (Private),11,6,17,24.79997072,93.95001705
MANIPUR,2001,Tempo/Vans (Government),0,0,0,24.79997072,93.95001705
MANIPUR,2001,Tempo/Vans (Private),0,0,0,24.79997072,93.95001705
MANIPUR,2001,Jeep (Government),0,1,1,24.79997072,93.95001705
MANIPUR,2001,Jeep (Private),5,4,9,24.79997072,93.95001705
MANIPUR,2001,Car (Government),0,0,0,24.79997072,93.95001705
MANIPUR,2001,Car (Private),2,0,2,24.79997072,93.95001705
MANIPUR,2001,Three Wheeler,0,0,0,24.79997072,93.95001705
MANIPUR,2001,Two Wheeler,10,0,10,24.79997072,93.95001705
MANIPUR,2001,Bicycle,1,0,1,24.79997072,93.95001705
MANIPUR,2001,Pedestrian,6,3,9,24.79997072,93.95001705
MANIPUR,2001,Others (Please Specify),4,0,4,24.79997072,93.95001705
MANIPUR,2002,Truck/Lorry (Government),3,1,4,24.79997072,93.95001705
MANIPUR,2002,Truck/Lorry (Private),15,5,20,24.79997072,93.95001705
MANIPUR,2002,Bus (Government),0,0,0,24.79997072,93.95001705
MANIPUR,2002,Bus (Private),21,13,34,24.79997072,93.95001705
MANIPUR,2002,Tempo/Vans (Government),0,0,0,24.79997072,93.95001705
MANIPUR,2002,Tempo/Vans (Private),6,0,6,24.79997072,93.95001705
MANIPUR,2002,Jeep (Government),0,0,0,24.79997072,93.95001705
MANIPUR,2002,Jeep (Private),3,1,4,24.79997072,93.95001705
MANIPUR,2002,Car (Government),0,0,0,24.79997072,93.95001705
MANIPUR,2002,Car (Private),0,0,0,24.79997072,93.95001705
MANIPUR,2002,Three Wheeler,1,0,1,24.79997072,93.95001705
MANIPUR,2002,Two Wheeler,27,4,31,24.79997072,93.95001705
MANIPUR,2002,Bicycle,4,2,6,24.79997072,93.95001705
MANIPUR,2002,Pedestrian,9,1,10,24.79997072,93.95001705
MANIPUR,2002,Others (Please Specify),3,1,4,24.79997072,93.95001705
MANIPUR,2003,Truck/Lorry (Government),0,0,0,24.79997072,93.95001705
MANIPUR,2003,Truck/Lorry (Private),15,8,23,24.79997072,93.95001705
MANIPUR,2003,Bus (Government),0,1,1,24.79997072,93.95001705
MANIPUR,2003,Bus (Private),27,3,30,24.79997072,93.95001705
MANIPUR,2003,Tempo/Vans (Government),0,0,0,24.79997072,93.95001705
MANIPUR,2003,Tempo/Vans (Private),0,0,0,24.79997072,93.95001705
MANIPUR,2003,Jeep (Government),0,0,0,24.79997072,93.95001705
MANIPUR,2003,Jeep (Private),2,0,2,24.79997072,93.95001705
MANIPUR,2003,Car (Government),0,0,0,24.79997072,93.95001705
MANIPUR,2003,Car (Private),4,0,4,24.79997072,93.95001705
MANIPUR,2003,Three Wheeler,1,1,2,24.79997072,93.95001705
MANIPUR,2003,Two Wheeler,24,1,25,24.79997072,93.95001705
MANIPUR,2003,Bicycle,9,1,10,24.79997072,93.95001705
MANIPUR,2003,Pedestrian,16,9,25,24.79997072,93.95001705
MANIPUR,2003,Others (Please Specify),2,0,2,24.79997072,93.95001705
MANIPUR,2004,Truck/Lorry (Government),3,0,3,24.79997072,93.95001705
MANIPUR,2004,Truck/Lorry (Private),31,1,32,24.79997072,93.95001705
MANIPUR,2004,Bus (Government),0,0,0,24.79997072,93.95001705
MANIPUR,2004,Bus (Private),32,9,41,24.79997072,93.95001705
MANIPUR,2004,Tempo/Vans (Government),0,0,0,24.79997072,93.95001705
MANIPUR,2004,Tempo/Vans (Private),0,0,0,24.79997072,93.95001705
MANIPUR,2004,Jeep (Government),0,0,0,24.79997072,93.95001705
MANIPUR,2004,Jeep (Private),7,2,9,24.79997072,93.95001705
MANIPUR,2004,Car (Government),0,0,0,24.79997072,93.95001705
MANIPUR,2004,Car (Private),1,1,2,24.79997072,93.95001705
MANIPUR,2004,Three Wheeler,1,0,1,24.79997072,93.95001705
MANIPUR,2004,Two Wheeler,16,3,19,24.79997072,93.95001705
MANIPUR,2004,Bicycle,0,0,0,24.79997072,93.95001705
MANIPUR,2004,Pedestrian,7,0,7,24.79997072,93.95001705
MANIPUR,2004,Others (Please Specify),4,1,5,24.79997072,93.95001705
MANIPUR,2005,Truck/Lorry (Government),0,0,0,24.79997072,93.95001705
MANIPUR,2005,Truck/Lorry (Private),28,5,33,24.79997072,93.95001705
MANIPUR,2005,Bus (Government),1,0,1,24.79997072,93.95001705
MANIPUR,2005,Bus (Private),22,8,30,24.79997072,93.95001705
MANIPUR,2005,Tempo/Vans (Government),0,0,0,24.79997072,93.95001705
MANIPUR,2005,Tempo/Vans (Private),0,0,0,24.79997072,93.95001705
MANIPUR,2005,Jeep (Government),0,0,0,24.79997072,93.95001705
MANIPUR,2005,Jeep (Private),6,1,7,24.79997072,93.95001705
MANIPUR,2005,Car (Government),0,0,0,24.79997072,93.95001705
MANIPUR,2005,Car (Private),4,0,4,24.79997072,93.95001705
MANIPUR,2005,Three Wheeler,0,0,0,24.79997072,93.95001705
MANIPUR,2005,Two Wheeler,30,2,32,24.79997072,93.95001705
MANIPUR,2005,Bicycle,5,0,5,24.79997072,93.95001705
MANIPUR,2005,Pedestrian,11,11,22,24.79997072,93.95001705
MANIPUR,2005,Others (Please Specify),2,2,4,24.79997072,93.95001705
MANIPUR,2006,Truck/Lorry (Government),6,1,7,24.79997072,93.95001705
MANIPUR,2006,Truck/Lorry (Private),16,4,20,24.79997072,93.95001705
MANIPUR,2006,Bus (Government),0,0,0,24.79997072,93.95001705
MANIPUR,2006,Bus (Private),20,12,32,24.79997072,93.95001705
MANIPUR,2006,Tempo/Vans (Government),0,0,0,24.79997072,93.95001705
MANIPUR,2006,Tempo/Vans (Private),4,0,4,24.79997072,93.95001705
MANIPUR,2006,Jeep (Government),3,0,3,24.79997072,93.95001705
MANIPUR,2006,Jeep (Private),5,5,10,24.79997072,93.95001705
MANIPUR,2006,Car (Government),0,0,0,24.79997072,93.95001705
MANIPUR,2006,Car (Private),1,0,1,24.79997072,93.95001705
MANIPUR,2006,Three Wheeler,1,0,1,24.79997072,93.95001705
MANIPUR,2006,Two Wheeler,31,4,35,24.79997072,93.95001705
MANIPUR,2006,Bicycle,4,4,8,24.79997072,93.95001705
MANIPUR,2006,Pedestrian,17,7,24,24.79997072,93.95001705
MANIPUR,2006,Others (Please Specify),10,2,12,24.79997072,93.95001705
MANIPUR,2007,Truck/Lorry (Government),3,0,3,24.79997072,93.95001705
MANIPUR,2007,Truck/Lorry (Private),27,5,32,24.79997072,93.95001705
MANIPUR,2007,Bus (Government),0,0,0,24.79997072,93.95001705
MANIPUR,2007,Bus (Private),14,6,20,24.79997072,93.95001705
MANIPUR,2007,Tempo/Vans (Government),0,0,0,24.79997072,93.95001705
MANIPUR,2007,Tempo/Vans (Private),0,0,0,24.79997072,93.95001705
MANIPUR,2007,Jeep (Government),2,0,2,24.79997072,93.95001705
MANIPUR,2007,Jeep (Private),5,1,6,24.79997072,93.95001705
MANIPUR,2007,Car (Government),0,0,0,24.79997072,93.95001705
MANIPUR,2007,Car (Private),2,0,2,24.79997072,93.95001705
MANIPUR,2007,Three Wheeler,1,2,3,24.79997072,93.95001705
MANIPUR,2007,Two Wheeler,17,4,21,24.79997072,93.95001705
MANIPUR,2007,Bicycle,6,0,6,24.79997072,93.95001705
MANIPUR,2007,Pedestrian,11,4,15,24.79997072,93.95001705
MANIPUR,2007,Others (Please Specify),4,0,4,24.79997072,93.95001705
MANIPUR,2008,Truck/Lorry (Government),3,0,3,24.79997072,93.95001705
MANIPUR,2008,Truck/Lorry (Private),32,22,54,24.79997072,93.95001705
MANIPUR,2008,Bus (Government),0,0,0,24.79997072,93.95001705
MANIPUR,2008,Bus (Private),16,1,17,24.79997072,93.95001705
MANIPUR,2008,Tempo/Vans (Government),0,0,0,24.79997072,93.95001705
MANIPUR,2008,Tempo/Vans (Private),2,1,3,24.79997072,93.95001705
MANIPUR,2008,Jeep (Government),0,0,0,24.79997072,93.95001705
MANIPUR,2008,Jeep (Private),10,1,11,24.79997072,93.95001705
MANIPUR,2008,Car (Government),0,0,0,24.79997072,93.95001705
MANIPUR,2008,Car (Private),3,1,4,24.79997072,93.95001705
MANIPUR,2008,Three Wheeler,0,0,0,24.79997072,93.95001705
MANIPUR,2008,Two Wheeler,22,1,23,24.79997072,93.95001705
MANIPUR,2008,Bicycle,2,2,4,24.79997072,93.95001705
MANIPUR,2008,Pedestrian,2,2,4,24.79997072,93.95001705
MANIPUR,2008,Others (Please Specify),8,2,10,24.79997072,93.95001705
MANIPUR,2009,Truck/Lorry (Government),2,0,2,24.79997072,93.95001705
MANIPUR,2009,Truck/Lorry (Private),39,9,48,24.79997072,93.95001705
MANIPUR,2009,Bus (Government),0,0,0,24.79997072,93.95001705
MANIPUR,2009,Bus (Private),21,8,29,24.79997072,93.95001705
MANIPUR,2009,Tempo/Vans (Government),0,0,0,24.79997072,93.95001705
MANIPUR,2009,Tempo/Vans (Private),3,0,3,24.79997072,93.95001705
MANIPUR,2009,Jeep (Government),0,0,0,24.79997072,93.95001705
MANIPUR,2009,Jeep (Private),3,0,3,24.79997072,93.95001705
MANIPUR,2009,Car (Government),3,0,3,24.79997072,93.95001705
MANIPUR,2009,Car (Private),1,2,3,24.79997072,93.95001705
MANIPUR,2009,Three Wheeler,3,2,5,24.79997072,93.95001705
MANIPUR,2009,Two Wheeler,14,5,19,24.79997072,93.95001705
MANIPUR,2009,Bicycle,1,1,2,24.79997072,93.95001705
MANIPUR,2009,Pedestrian,2,2,4,24.79997072,93.95001705
MANIPUR,2009,Others (Please Specify),3,1,4,24.79997072,93.95001705
MANIPUR,2010,Truck/Lorry (Government),14,0,14,24.79997072,93.95001705
MANIPUR,2010,Truck/Lorry (Private),34,11,45,24.79997072,93.95001705
MANIPUR,2010,Bus (Government),2,0,2,24.79997072,93.95001705
MANIPUR,2010,Bus (Private),9,1,10,24.79997072,93.95001705
MANIPUR,2010,Tempo/Vans (Government),0,0,0,24.79997072,93.95001705
MANIPUR,2010,Tempo/Vans (Private),8,0,8,24.79997072,93.95001705
MANIPUR,2010,Jeep (Government),1,0,1,24.79997072,93.95001705
MANIPUR,2010,Jeep (Private),4,1,5,24.79997072,93.95001705
MANIPUR,2010,Car (Government),0,0,0,24.79997072,93.95001705
MANIPUR,2010,Car (Private),5,2,7,24.79997072,93.95001705
MANIPUR,2010,Three Wheeler,4,1,5,24.79997072,93.95001705
MANIPUR,2010,Two Wheeler,25,10,35,24.79997072,93.95001705
MANIPUR,2010,Bicycle,1,0,1,24.79997072,93.95001705
MANIPUR,2010,Pedestrian,0,0,0,24.79997072,93.95001705
MANIPUR,2010,Others (Please Specify),13,7,20,24.79997072,93.95001705
MANIPUR,2011,Truck/Lorry (Government),3,1,4,24.79997072,93.95001705
MANIPUR,2011,Truck/Lorry (Private),29,3,32,24.79997072,93.95001705
MANIPUR,2011,Bus (Government),0,0,0,24.79997072,93.95001705
MANIPUR,2011,Bus (Private),9,0,9,24.79997072,93.95001705
MANIPUR,2011,Tempo/Vans (Government),0,0,0,24.79997072,93.95001705
MANIPUR,2011,Tempo/Vans (Private),5,1,6,24.79997072,93.95001705
MANIPUR,2011,Jeep (Government),0,0,0,24.79997072,93.95001705
MANIPUR,2011,Jeep (Private),9,1,10,24.79997072,93.95001705
MANIPUR,2011,Car (Government),0,0,0,24.79997072,93.95001705
MANIPUR,2011,Car (Private),11,0,11,24.79997072,93.95001705
MANIPUR,2011,Three Wheeler,6,1,7,24.79997072,93.95001705
MANIPUR,2011,Two Wheeler,33,3,36,24.79997072,93.95001705
MANIPUR,2011,Bicycle,5,0,5,24.79997072,93.95001705
MANIPUR,2011,Pedestrian,17,7,24,24.79997072,93.95001705
MANIPUR,2011,Others (Please Specify),10,2,12,24.79997072,93.95001705
MANIPUR,2012,Truck/Lorry (Government),2,0,2,24.79997072,93.95001705
MANIPUR,2012,Truck/Lorry (Private),35,3,38,24.79997072,93.95001705
MANIPUR,2012,Bus (Government),0,0,0,24.79997072,93.95001705
MANIPUR,2012,Bus (Private),10,7,17,24.79997072,93.95001705
MANIPUR,2012,Tempo/Vans (Government),0,0,0,24.79997072,93.95001705
MANIPUR,2012,Tempo/Vans (Private),5,2,7,24.79997072,93.95001705
MANIPUR,2012,Jeep (Government),0,0,0,24.79997072,93.95001705
MANIPUR,2012,Jeep (Private),4,2,6,24.79997072,93.95001705
MANIPUR,2012,Car (Government),0,0,0,24.79997072,93.95001705
MANIPUR,2012,Car (Private),6,0,6,24.79997072,93.95001705
MANIPUR,2012,Three Wheeler,4,0,4,24.79997072,93.95001705
MANIPUR,2012,Two Wheeler,39,4,43,24.79997072,93.95001705
MANIPUR,2012,Bicycle,1,0,1,24.79997072,93.95001705
MANIPUR,2012,Pedestrian,16,7,23,24.79997072,93.95001705
MANIPUR,2012,Others (Please Specify),8,3,11,24.79997072,93.95001705
MEGHALAYA,2001,Truck/Lorry (Government),4,0,4,25.57049217,91.8800142
MEGHALAYA,2001,Truck/Lorry (Private),52,3,55,25.57049217,91.8800142
MEGHALAYA,2001,Bus (Government),0,0,0,25.57049217,91.8800142
MEGHALAYA,2001,Bus (Private),32,1,33,25.57049217,91.8800142
MEGHALAYA,2001,Tempo/Vans (Government),0,0,0,25.57049217,91.8800142
MEGHALAYA,2001,Tempo/Vans (Private),4,0,4,25.57049217,91.8800142
MEGHALAYA,2001,Jeep (Government),1,0,1,25.57049217,91.8800142
MEGHALAYA,2001,Jeep (Private),5,0,5,25.57049217,91.8800142
MEGHALAYA,2001,Car (Government),0,0,0,25.57049217,91.8800142
MEGHALAYA,2001,Car (Private),9,2,11,25.57049217,91.8800142
MEGHALAYA,2001,Three Wheeler,3,1,4,25.57049217,91.8800142
MEGHALAYA,2001,Two Wheeler,7,2,9,25.57049217,91.8800142
MEGHALAYA,2001,Bicycle,1,0,1,25.57049217,91.8800142
MEGHALAYA,2001,Pedestrian,2,4,6,25.57049217,91.8800142
MEGHALAYA,2001,Others (Please Specify),5,0,5,25.57049217,91.8800142
MEGHALAYA,2002,Truck/Lorry (Government),20,0,20,25.57049217,91.8800142
MEGHALAYA,2002,Truck/Lorry (Private),32,0,32,25.57049217,91.8800142
MEGHALAYA,2002,Bus (Government),3,0,3,25.57049217,91.8800142
MEGHALAYA,2002,Bus (Private),11,3,14,25.57049217,91.8800142
MEGHALAYA,2002,Tempo/Vans (Government),0,0,0,25.57049217,91.8800142
MEGHALAYA,2002,Tempo/Vans (Private),2,2,4,25.57049217,91.8800142
MEGHALAYA,2002,Jeep (Government),0,0,0,25.57049217,91.8800142
MEGHALAYA,2002,Jeep (Private),8,0,8,25.57049217,91.8800142
MEGHALAYA,2002,Car (Government),0,0,0,25.57049217,91.8800142
MEGHALAYA,2002,Car (Private),8,1,9,25.57049217,91.8800142
MEGHALAYA,2002,Three Wheeler,2,0,2,25.57049217,91.8800142
MEGHALAYA,2002,Two Wheeler,9,2,11,25.57049217,91.8800142
MEGHALAYA,2002,Bicycle,0,0,0,25.57049217,91.8800142
MEGHALAYA,2002,Pedestrian,13,4,17,25.57049217,91.8800142
MEGHALAYA,2002,Others (Please Specify),5,0,5,25.57049217,91.8800142
MEGHALAYA,2003,Truck/Lorry (Government),0,0,0,25.57049217,91.8800142
MEGHALAYA,2003,Truck/Lorry (Private),36,3,39,25.57049217,91.8800142
MEGHALAYA,2003,Bus (Government),0,0,0,25.57049217,91.8800142
MEGHALAYA,2003,Bus (Private),35,4,39,25.57049217,91.8800142
MEGHALAYA,2003,Tempo/Vans (Government),0,0,0,25.57049217,91.8800142
MEGHALAYA,2003,Tempo/Vans (Private),3,0,3,25.57049217,91.8800142
MEGHALAYA,2003,Jeep (Government),0,0,0,25.57049217,91.8800142
MEGHALAYA,2003,Jeep (Private),6,2,8,25.57049217,91.8800142
MEGHALAYA,2003,Car (Government),0,0,0,25.57049217,91.8800142
MEGHALAYA,2003,Car (Private),8,2,10,25.57049217,91.8800142
MEGHALAYA,2003,Three Wheeler,1,0,1,25.57049217,91.8800142
MEGHALAYA,2003,Two Wheeler,1,0,1,25.57049217,91.8800142
MEGHALAYA,2003,Bicycle,0,0,0,25.57049217,91.8800142
MEGHALAYA,2003,Pedestrian,6,5,11,25.57049217,91.8800142
MEGHALAYA,2003,Others (Please Specify),6,0,6,25.57049217,91.8800142
MEGHALAYA,2004,Truck/Lorry (Government),2,0,2,25.57049217,91.8800142
MEGHALAYA,2004,Truck/Lorry (Private),29,1,30,25.57049217,91.8800142
MEGHALAYA,2004,Bus (Government),2,0,2,25.57049217,91.8800142
MEGHALAYA,2004,Bus (Private),20,3,23,25.57049217,91.8800142
MEGHALAYA,2004,Tempo/Vans (Government),0,0,0,25.57049217,91.8800142
MEGHALAYA,2004,Tempo/Vans (Private),7,3,10,25.57049217,91.8800142
MEGHALAYA,2004,Jeep (Government),0,0,0,25.57049217,91.8800142
MEGHALAYA,2004,Jeep (Private),7,2,9,25.57049217,91.8800142
MEGHALAYA,2004,Car (Government),0,0,0,25.57049217,91.8800142
MEGHALAYA,2004,Car (Private),8,4,12,25.57049217,91.8800142
MEGHALAYA,2004,Three Wheeler,4,3,7,25.57049217,91.8800142
MEGHALAYA,2004,Two Wheeler,8,0,8,25.57049217,91.8800142
MEGHALAYA,2004,Bicycle,0,0,0,25.57049217,91.8800142
MEGHALAYA,2004,Pedestrian,16,2,18,25.57049217,91.8800142
MEGHALAYA,2004,Others (Please Specify),4,3,7,25.57049217,91.8800142
MEGHALAYA,2005,Truck/Lorry (Government),0,0,0,25.57049217,91.8800142
MEGHALAYA,2005,Truck/Lorry (Private),31,6,37,25.57049217,91.8800142
MEGHALAYA,2005,Bus (Government),0,0,0,25.57049217,91.8800142
MEGHALAYA,2005,Bus (Private),29,4,33,25.57049217,91.8800142
MEGHALAYA,2005,Tempo/Vans (Government),0,0,0,25.57049217,91.8800142
MEGHALAYA,2005,Tempo/Vans (Private),3,0,3,25.57049217,91.8800142
MEGHALAYA,2005,Jeep (Government),0,0,0,25.57049217,91.8800142
MEGHALAYA,2005,Jeep (Private),4,2,6,25.57049217,91.8800142
MEGHALAYA,2005,Car (Government),0,0,0,25.57049217,91.8800142
MEGHALAYA,2005,Car (Private),12,6,18,25.57049217,91.8800142
MEGHALAYA,2005,Three Wheeler,6,3,9,25.57049217,91.8800142
MEGHALAYA,2005,Two Wheeler,3,1,4,25.57049217,91.8800142
MEGHALAYA,2005,Bicycle,2,0,2,25.57049217,91.8800142
MEGHALAYA,2005,Pedestrian,5,3,8,25.57049217,91.8800142
MEGHALAYA,2005,Others (Please Specify),2,0,2,25.57049217,91.8800142
MEGHALAYA,2006,Truck/Lorry (Government),0,0,0,25.57049217,91.8800142
MEGHALAYA,2006,Truck/Lorry (Private),32,5,37,25.57049217,91.8800142
MEGHALAYA,2006,Bus (Government),0,0,0,25.57049217,91.8800142
MEGHALAYA,2006,Bus (Private),18,4,22,25.57049217,91.8800142
MEGHALAYA,2006,Tempo/Vans (Government),0,0,0,25.57049217,91.8800142
MEGHALAYA,2006,Tempo/Vans (Private),9,4,13,25.57049217,91.8800142
MEGHALAYA,2006,Jeep (Government),1,0,1,25.57049217,91.8800142
MEGHALAYA,2006,Jeep (Private),5,2,7,25.57049217,91.8800142
MEGHALAYA,2006,Car (Government),0,0,0,25.57049217,91.8800142
MEGHALAYA,2006,Car (Private),5,4,9,25.57049217,91.8800142
MEGHALAYA,2006,Three Wheeler,2,0,2,25.57049217,91.8800142
MEGHALAYA,2006,Two Wheeler,3,0,3,25.57049217,91.8800142
MEGHALAYA,2006,Bicycle,2,0,2,25.57049217,91.8800142
MEGHALAYA,2006,Pedestrian,15,5,20,25.57049217,91.8800142
MEGHALAYA,2006,Others (Please Specify),14,2,16,25.57049217,91.8800142
MEGHALAYA,2007,Truck/Lorry (Government),0,0,0,25.57049217,91.8800142
MEGHALAYA,2007,Truck/Lorry (Private),23,1,24,25.57049217,91.8800142
MEGHALAYA,2007,Bus (Government),0,0,0,25.57049217,91.8800142
MEGHALAYA,2007,Bus (Private),25,6,31,25.57049217,91.8800142
MEGHALAYA,2007,Tempo/Vans (Government),0,0,0,25.57049217,91.8800142
MEGHALAYA,2007,Tempo/Vans (Private),5,0,5,25.57049217,91.8800142
MEGHALAYA,2007,Jeep (Government),0,0,0,25.57049217,91.8800142
MEGHALAYA,2007,Jeep (Private),14,3,17,25.57049217,91.8800142
MEGHALAYA,2007,Car (Government),0,0,0,25.57049217,91.8800142
MEGHALAYA,2007,Car (Private),6,2,8,25.57049217,91.8800142
MEGHALAYA,2007,Three Wheeler,1,0,1,25.57049217,91.8800142
MEGHALAYA,2007,Two Wheeler,5,0,5,25.57049217,91.8800142
MEGHALAYA,2007,Bicycle,2,0,2,25.57049217,91.8800142
MEGHALAYA,2007,Pedestrian,17,2,19,25.57049217,91.8800142
MEGHALAYA,2007,Others (Please Specify),11,10,21,25.57049217,91.8800142
MEGHALAYA,2008,Truck/Lorry (Government),0,0,0,25.57049217,91.8800142
MEGHALAYA,2008,Truck/Lorry (Private),47,7,54,25.57049217,91.8800142
MEGHALAYA,2008,Bus (Government),0,0,0,25.57049217,91.8800142
MEGHALAYA,2008,Bus (Private),26,9,35,25.57049217,91.8800142
MEGHALAYA,2008,Tempo/Vans (Government),0,0,0,25.57049217,91.8800142
MEGHALAYA,2008,Tempo/Vans (Private),7,1,8,25.57049217,91.8800142
MEGHALAYA,2008,Jeep (Government),0,0,0,25.57049217,91.8800142
MEGHALAYA,2008,Jeep (Private),4,0,4,25.57049217,91.8800142
MEGHALAYA,2008,Car (Government),0,0,0,25.57049217,91.8800142
MEGHALAYA,2008,Car (Private),17,10,27,25.57049217,91.8800142
MEGHALAYA,2008,Three Wheeler,7,0,7,25.57049217,91.8800142
MEGHALAYA,2008,Two Wheeler,3,0,3,25.57049217,91.8800142
MEGHALAYA,2008,Bicycle,1,0,1,25.57049217,91.8800142
MEGHALAYA,2008,Pedestrian,4,2,6,25.57049217,91.8800142
MEGHALAYA,2008,Others (Please Specify),4,0,4,25.57049217,91.8800142
MEGHALAYA,2009,Truck/Lorry (Government),0,0,0,25.57049217,91.8800142
MEGHALAYA,2009,Truck/Lorry (Private),45,6,51,25.57049217,91.8800142
MEGHALAYA,2009,Bus (Government),0,0,0,25.57049217,91.8800142
MEGHALAYA,2009,Bus (Private),41,4,45,25.57049217,91.8800142
MEGHALAYA,2009,Tempo/Vans (Government),0,0,0,25.57049217,91.8800142
MEGHALAYA,2009,Tempo/Vans (Private),14,0,14,25.57049217,91.8800142
MEGHALAYA,2009,Jeep (Government),0,0,0,25.57049217,91.8800142
MEGHALAYA,2009,Jeep (Private),8,1,9,25.57049217,91.8800142
MEGHALAYA,2009,Car (Government),0,0,0,25.57049217,91.8800142
MEGHALAYA,2009,Car (Private),29,1,30,25.57049217,91.8800142
MEGHALAYA,2009,Three Wheeler,2,0,2,25.57049217,91.8800142
MEGHALAYA,2009,Two Wheeler,6,0,6,25.57049217,91.8800142
MEGHALAYA,2009,Bicycle,2,0,2,25.57049217,91.8800142
MEGHALAYA,2009,Pedestrian,13,4,17,25.57049217,91.8800142
MEGHALAYA,2009,Others (Please Specify),15,2,17,25.57049217,91.8800142
MEGHALAYA,2010,Truck/Lorry (Government),13,3,16,25.57049217,91.8800142
MEGHALAYA,2010,Truck/Lorry (Private),55,3,58,25.57049217,91.8800142
MEGHALAYA,2010,Bus (Government),4,1,5,25.57049217,91.8800142
MEGHALAYA,2010,Bus (Private),10,1,11,25.57049217,91.8800142
MEGHALAYA,2010,Tempo/Vans (Government),2,1,3,25.57049217,91.8800142
MEGHALAYA,2010,Tempo/Vans (Private),13,2,15,25.57049217,91.8800142
MEGHALAYA,2010,Jeep (Government),0,0,0,25.57049217,91.8800142
MEGHALAYA,2010,Jeep (Private),8,6,14,25.57049217,91.8800142
MEGHALAYA,2010,Car (Government),0,0,0,25.57049217,91.8800142
MEGHALAYA,2010,Car (Private),15,3,18,25.57049217,91.8800142
MEGHALAYA,2010,Three Wheeler,5,0,5,25.57049217,91.8800142
MEGHALAYA,2010,Two Wheeler,11,1,12,25.57049217,91.8800142
MEGHALAYA,2010,Bicycle,1,0,1,25.57049217,91.8800142
MEGHALAYA,2010,Pedestrian,13,4,17,25.57049217,91.8800142
MEGHALAYA,2010,Others (Please Specify),8,1,9,25.57049217,91.8800142
MEGHALAYA,2011,Truck/Lorry (Government),4,0,4,25.57049217,91.8800142
MEGHALAYA,2011,Truck/Lorry (Private),93,1,94,25.57049217,91.8800142
MEGHALAYA,2011,Bus (Government),1,1,2,25.57049217,91.8800142
MEGHALAYA,2011,Bus (Private),13,5,18,25.57049217,91.8800142
MEGHALAYA,2011,Tempo/Vans (Government),2,0,2,25.57049217,91.8800142
MEGHALAYA,2011,Tempo/Vans (Private),13,1,14,25.57049217,91.8800142
MEGHALAYA,2011,Jeep (Government),2,0,2,25.57049217,91.8800142
MEGHALAYA,2011,Jeep (Private),4,0,4,25.57049217,91.8800142
MEGHALAYA,2011,Car (Government),2,0,2,25.57049217,91.8800142
MEGHALAYA,2011,Car (Private),22,4,26,25.57049217,91.8800142
MEGHALAYA,2011,Three Wheeler,3,4,7,25.57049217,91.8800142
MEGHALAYA,2011,Two Wheeler,20,2,22,25.57049217,91.8800142
MEGHALAYA,2011,Bicycle,0,0,0,25.57049217,91.8800142
MEGHALAYA,2011,Pedestrian,15,4,19,25.57049217,91.8800142
MEGHALAYA,2011,Others (Please Specify),8,5,13,25.57049217,91.8800142
MEGHALAYA,2012,Truck/Lorry (Government),0,0,0,25.57049217,91.8800142
MEGHALAYA,2012,Truck/Lorry (Private),62,9,71,25.57049217,91.8800142
MEGHALAYA,2012,Bus (Government),0,0,0,25.57049217,91.8800142
MEGHALAYA,2012,Bus (Private),48,2,50,25.57049217,91.8800142
MEGHALAYA,2012,Tempo/Vans (Government),1,0,1,25.57049217,91.8800142
MEGHALAYA,2012,Tempo/Vans (Private),5,2,7,25.57049217,91.8800142
MEGHALAYA,2012,Jeep (Government),10,0,10,25.57049217,91.8800142
MEGHALAYA,2012,Jeep (Private),3,0,3,25.57049217,91.8800142
MEGHALAYA,2012,Car (Government),7,3,10,25.57049217,91.8800142
MEGHALAYA,2012,Car (Private),7,1,8,25.57049217,91.8800142
MEGHALAYA,2012,Three Wheeler,10,4,14,25.57049217,91.8800142
MEGHALAYA,2012,Two Wheeler,22,3,25,25.57049217,91.8800142
MEGHALAYA,2012,Bicycle,0,0,0,25.57049217,91.8800142
MEGHALAYA,2012,Pedestrian,0,1,1,25.57049217,91.8800142
MEGHALAYA,2012,Others (Please Specify),11,2,13,25.57049217,91.8800142
MIZORAM,2001,Truck/Lorry (Government),1,0,1,23.71039899,92.72001461
MIZORAM,2001,Truck/Lorry (Private),19,5,24,23.71039899,92.72001461
MIZORAM,2001,Bus (Government),0,0,0,23.71039899,92.72001461
MIZORAM,2001,Bus (Private),20,8,28,23.71039899,92.72001461
MIZORAM,2001,Tempo/Vans (Government),0,0,0,23.71039899,92.72001461
MIZORAM,2001,Tempo/Vans (Private),7,1,8,23.71039899,92.72001461
MIZORAM,2001,Jeep (Government),0,0,0,23.71039899,92.72001461
MIZORAM,2001,Jeep (Private),3,2,5,23.71039899,92.72001461
MIZORAM,2001,Car (Government),0,0,0,23.71039899,92.72001461
MIZORAM,2001,Car (Private),0,0,0,23.71039899,92.72001461
MIZORAM,2001,Three Wheeler,0,0,0,23.71039899,92.72001461
MIZORAM,2001,Two Wheeler,1,0,1,23.71039899,92.72001461
MIZORAM,2001,Bicycle,0,0,0,23.71039899,92.72001461
MIZORAM,2001,Pedestrian,0,0,0,23.71039899,92.72001461
MIZORAM,2001,Others (Please Specify),0,0,0,23.71039899,92.72001461
MIZORAM,2002,Truck/Lorry (Government),1,0,1,23.71039899,92.72001461
MIZORAM,2002,Truck/Lorry (Private),16,2,18,23.71039899,92.72001461
MIZORAM,2002,Bus (Government),0,0,0,23.71039899,92.72001461
MIZORAM,2002,Bus (Private),4,1,5,23.71039899,92.72001461
MIZORAM,2002,Tempo/Vans (Government),0,0,0,23.71039899,92.72001461
MIZORAM,2002,Tempo/Vans (Private),0,0,0,23.71039899,92.72001461
MIZORAM,2002,Jeep (Government),0,0,0,23.71039899,92.72001461
MIZORAM,2002,Jeep (Private),5,3,8,23.71039899,92.72001461
MIZORAM,2002,Car (Government),0,0,0,23.71039899,92.72001461
MIZORAM,2002,Car (Private),1,0,1,23.71039899,92.72001461
MIZORAM,2002,Three Wheeler,3,2,5,23.71039899,92.72001461
MIZORAM,2002,Two Wheeler,3,0,3,23.71039899,92.72001461
MIZORAM,2002,Bicycle,0,0,0,23.71039899,92.72001461
MIZORAM,2002,Pedestrian,1,0,1,23.71039899,92.72001461
MIZORAM,2002,Others (Please Specify),7,1,8,23.71039899,92.72001461
MIZORAM,2003,Truck/Lorry (Government),0,0,0,23.71039899,92.72001461
MIZORAM,2003,Truck/Lorry (Private),36,7,43,23.71039899,92.72001461
MIZORAM,2003,Bus (Government),3,0,3,23.71039899,92.72001461
MIZORAM,2003,Bus (Private),3,0,3,23.71039899,92.72001461
MIZORAM,2003,Tempo/Vans (Government),1,0,1,23.71039899,92.72001461
MIZORAM,2003,Tempo/Vans (Private),1,0,1,23.71039899,92.72001461
MIZORAM,2003,Jeep (Government),0,0,0,23.71039899,92.72001461
MIZORAM,2003,Jeep (Private),5,0,5,23.71039899,92.72001461
MIZORAM,2003,Car (Government),0,0,0,23.71039899,92.72001461
MIZORAM,2003,Car (Private),6,4,10,23.71039899,92.72001461
MIZORAM,2003,Three Wheeler,4,0,4,23.71039899,92.72001461
MIZORAM,2003,Two Wheeler,4,1,5,23.71039899,92.72001461
MIZORAM,2003,Bicycle,0,0,0,23.71039899,92.72001461
MIZORAM,2003,Pedestrian,0,0,0,23.71039899,92.72001461
MIZORAM,2003,Others (Please Specify),0,1,1,23.71039899,92.72001461
MIZORAM,2004,Truck/Lorry (Government),3,0,3,23.71039899,92.72001461
MIZORAM,2004,Truck/Lorry (Private),14,5,19,23.71039899,92.72001461
MIZORAM,2004,Bus (Government),0,0,0,23.71039899,92.72001461
MIZORAM,2004,Bus (Private),5,3,8,23.71039899,92.72001461
MIZORAM,2004,Tempo/Vans (Government),0,0,0,23.71039899,92.72001461
MIZORAM,2004,Tempo/Vans (Private),0,0,0,23.71039899,92.72001461
MIZORAM,2004,Jeep (Government),0,0,0,23.71039899,92.72001461
MIZORAM,2004,Jeep (Private),4,4,8,23.71039899,92.72001461
MIZORAM,2004,Car (Government),0,0,0,23.71039899,92.72001461
MIZORAM,2004,Car (Private),3,3,6,23.71039899,92.72001461
MIZORAM,2004,Three Wheeler,4,2,6,23.71039899,92.72001461
MIZORAM,2004,Two Wheeler,4,2,6,23.71039899,92.72001461
MIZORAM,2004,Bicycle,0,0,0,23.71039899,92.72001461
MIZORAM,2004,Pedestrian,0,0,0,23.71039899,92.72001461
MIZORAM,2004,Others (Please Specify),9,2,11,23.71039899,92.72001461
MIZORAM,2005,Truck/Lorry (Government),0,0,0,23.71039899,92.72001461
MIZORAM,2005,Truck/Lorry (Private),15,6,21,23.71039899,92.72001461
MIZORAM,2005,Bus (Government),0,0,0,23.71039899,92.72001461
MIZORAM,2005,Bus (Private),2,1,3,23.71039899,92.72001461
MIZORAM,2005,Tempo/Vans (Government),0,0,0,23.71039899,92.72001461
MIZORAM,2005,Tempo/Vans (Private),3,1,4,23.71039899,92.72001461
MIZORAM,2005,Jeep (Government),1,0,1,23.71039899,92.72001461
MIZORAM,2005,Jeep (Private),6,3,9,23.71039899,92.72001461
MIZORAM,2005,Car (Government),0,0,0,23.71039899,92.72001461
MIZORAM,2005,Car (Private),1,0,1,23.71039899,92.72001461
MIZORAM,2005,Three Wheeler,0,0,0,23.71039899,92.72001461
MIZORAM,2005,Two Wheeler,7,2,9,23.71039899,92.72001461
MIZORAM,2005,Bicycle,0,0,0,23.71039899,92.72001461
MIZORAM,2005,Pedestrian,0,0,0,23.71039899,92.72001461
MIZORAM,2005,Others (Please Specify),4,0,4,23.71039899,92.72001461
MIZORAM,2006,Truck/Lorry (Government),0,0,0,23.71039899,92.72001461
MIZORAM,2006,Truck/Lorry (Private),18,1,19,23.71039899,92.72001461
MIZORAM,2006,Bus (Government),0,0,0,23.71039899,92.72001461
MIZORAM,2006,Bus (Private),10,3,13,23.71039899,92.72001461
MIZORAM,2006,Tempo/Vans (Government),0,0,0,23.71039899,92.72001461
MIZORAM,2006,Tempo/Vans (Private),4,1,5,23.71039899,92.72001461
MIZORAM,2006,Jeep (Government),0,0,0,23.71039899,92.72001461
MIZORAM,2006,Jeep (Private),7,1,8,23.71039899,92.72001461
MIZORAM,2006,Car (Government),0,0,0,23.71039899,92.72001461
MIZORAM,2006,Car (Private),1,1,2,23.71039899,92.72001461
MIZORAM,2006,Three Wheeler,0,0,0,23.71039899,92.72001461
MIZORAM,2006,Two Wheeler,8,1,9,23.71039899,92.72001461
MIZORAM,2006,Bicycle,0,0,0,23.71039899,92.72001461
MIZORAM,2006,Pedestrian,0,0,0,23.71039899,92.72001461
MIZORAM,2006,Others (Please Specify),8,0,8,23.71039899,92.72001461
MIZORAM,2007,Truck/Lorry (Government),0,0,0,23.71039899,92.72001461
MIZORAM,2007,Truck/Lorry (Private),9,1,10,23.71039899,92.72001461
MIZORAM,2007,Bus (Government),0,0,0,23.71039899,92.72001461
MIZORAM,2007,Bus (Private),2,2,4,23.71039899,92.72001461
MIZORAM,2007,Tempo/Vans (Government),0,0,0,23.71039899,92.72001461
MIZORAM,2007,Tempo/Vans (Private),0,0,0,23.71039899,92.72001461
MIZORAM,2007,Jeep (Government),0,0,0,23.71039899,92.72001461
MIZORAM,2007,Jeep (Private),10,3,13,23.71039899,92.72001461
MIZORAM,2007,Car (Government),0,0,0,23.71039899,92.72001461
MIZORAM,2007,Car (Private),2,0,2,23.71039899,92.72001461
MIZORAM,2007,Three Wheeler,0,0,0,23.71039899,92.72001461
MIZORAM,2007,Two Wheeler,5,0,5,23.71039899,92.72001461
MIZORAM,2007,Bicycle,0,0,0,23.71039899,92.72001461
MIZORAM,2007,Pedestrian,0,0,0,23.71039899,92.72001461
MIZORAM,2007,Others (Please Specify),0,1,1,23.71039899,92.72001461
MIZORAM,2008,Truck/Lorry (Government),0,0,0,23.71039899,92.72001461
MIZORAM,2008,Truck/Lorry (Private),27,2,29,23.71039899,92.72001461
MIZORAM,2008,Bus (Government),0,0,0,23.71039899,92.72001461
MIZORAM,2008,Bus (Private),4,0,4,23.71039899,92.72001461
MIZORAM,2008,Tempo/Vans (Government),0,0,0,23.71039899,92.72001461
MIZORAM,2008,Tempo/Vans (Private),1,1,2,23.71039899,92.72001461
MIZORAM,2008,Jeep (Government),0,0,0,23.71039899,92.72001461
MIZORAM,2008,Jeep (Private),4,0,4,23.71039899,92.72001461
MIZORAM,2008,Car (Government),0,0,0,23.71039899,92.72001461
MIZORAM,2008,Car (Private),3,1,4,23.71039899,92.72001461
MIZORAM,2008,Three Wheeler,1,0,1,23.71039899,92.72001461
MIZORAM,2008,Two Wheeler,7,1,8,23.71039899,92.72001461
MIZORAM,2008,Bicycle,0,0,0,23.71039899,92.72001461
MIZORAM,2008,Pedestrian,0,0,0,23.71039899,92.72001461
MIZORAM,2008,Others (Please Specify),23,3,26,23.71039899,92.72001461
MIZORAM,2009,Truck/Lorry (Government),0,0,0,23.71039899,92.72001461
MIZORAM,2009,Truck/Lorry (Private),21,1,22,23.71039899,92.72001461
MIZORAM,2009,Bus (Government),1,0,1,23.71039899,92.72001461
MIZORAM,2009,Bus (Private),6,2,8,23.71039899,92.72001461
MIZORAM,2009,Tempo/Vans (Government),2,0,2,23.71039899,92.72001461
MIZORAM,2009,Tempo/Vans (Private),0,0,0,23.71039899,92.72001461
MIZORAM,2009,Jeep (Government),3,0,3,23.71039899,92.72001461
MIZORAM,2009,Jeep (Private),1,1,2,23.71039899,92.72001461
MIZORAM,2009,Car (Government),5,0,5,23.71039899,92.72001461
MIZORAM,2009,Car (Private),5,0,5,23.71039899,92.72001461
MIZORAM,2009,Three Wheeler,0,1,1,23.71039899,92.72001461
MIZORAM,2009,Two Wheeler,2,2,4,23.71039899,92.72001461
MIZORAM,2009,Bicycle,0,0,0,23.71039899,92.72001461
MIZORAM,2009,Pedestrian,0,0,0,23.71039899,92.72001461
MIZORAM,2009,Others (Please Specify),8,2,10,23.71039899,92.72001461
MIZORAM,2010,Truck/Lorry (Government),0,0,0,23.71039899,92.72001461
MIZORAM,2010,Truck/Lorry (Private),18,4,22,23.71039899,92.72001461
MIZORAM,2010,Bus (Government),22,1,23,23.71039899,92.72001461
MIZORAM,2010,Bus (Private),0,0,0,23.71039899,92.72001461
MIZORAM,2010,Tempo/Vans (Government),0,0,0,23.71039899,92.72001461
MIZORAM,2010,Tempo/Vans (Private),0,2,2,23.71039899,92.72001461
MIZORAM,2010,Jeep (Government),0,0,0,23.71039899,92.72001461
MIZORAM,2010,Jeep (Private),4,1,5,23.71039899,92.72001461
MIZORAM,2010,Car (Government),1,3,4,23.71039899,92.72001461
MIZORAM,2010,Car (Private),0,0,0,23.71039899,92.72001461
MIZORAM,2010,Three Wheeler,0,0,0,23.71039899,92.72001461
MIZORAM,2010,Two Wheeler,10,4,14,23.71039899,92.72001461
MIZORAM,2010,Bicycle,0,0,0,23.71039899,92.72001461
MIZORAM,2010,Pedestrian,0,0,0,23.71039899,92.72001461
MIZORAM,2010,Others (Please Specify),9,3,12,23.71039899,92.72001461
MIZORAM,2011,Truck/Lorry (Government),0,0,0,23.71039899,92.72001461
MIZORAM,2011,Truck/Lorry (Private),24,6,30,23.71039899,92.72001461
MIZORAM,2011,Bus (Government),0,0,0,23.71039899,92.72001461
MIZORAM,2011,Bus (Private),12,9,21,23.71039899,92.72001461
MIZORAM,2011,Tempo/Vans (Government),0,0,0,23.71039899,92.72001461
MIZORAM,2011,Tempo/Vans (Private),0,0,0,23.71039899,92.72001461
MIZORAM,2011,Jeep (Government),0,0,0,23.71039899,92.72001461
MIZORAM,2011,Jeep (Private),2,0,2,23.71039899,92.72001461
MIZORAM,2011,Car (Government),0,0,0,23.71039899,92.72001461
MIZORAM,2011,Car (Private),5,3,8,23.71039899,92.72001461
MIZORAM,2011,Three Wheeler,0,0,0,23.71039899,92.72001461
MIZORAM,2011,Two Wheeler,10,2,12,23.71039899,92.72001461
MIZORAM,2011,Bicycle,1,1,2,23.71039899,92.72001461
MIZORAM,2011,Pedestrian,0,1,1,23.71039899,92.72001461
MIZORAM,2011,Others (Please Specify),5,0,5,23.71039899,92.72001461
MIZORAM,2012,Truck/Lorry (Government),0,0,0,23.71039899,92.72001461
MIZORAM,2012,Truck/Lorry (Private),17,1,18,23.71039899,92.72001461
MIZORAM,2012,Bus (Government),0,0,0,23.71039899,92.72001461
MIZORAM,2012,Bus (Private),4,0,4,23.71039899,92.72001461
MIZORAM,2012,Tempo/Vans (Government),0,0,0,23.71039899,92.72001461
MIZORAM,2012,Tempo/Vans (Private),6,0,6,23.71039899,92.72001461
MIZORAM,2012,Jeep (Government),0,0,0,23.71039899,92.72001461
MIZORAM,2012,Jeep (Private),9,0,9,23.71039899,92.72001461
MIZORAM,2012,Car (Government),0,0,0,23.71039899,92.72001461
MIZORAM,2012,Car (Private),4,6,10,23.71039899,92.72001461
MIZORAM,2012,Three Wheeler,2,0,2,23.71039899,92.72001461
MIZORAM,2012,Two Wheeler,17,7,24,23.71039899,92.72001461
MIZORAM,2012,Bicycle,0,0,0,23.71039899,92.72001461
MIZORAM,2012,Pedestrian,2,1,3,23.71039899,92.72001461
MIZORAM,2012,Others (Please Specify),1,0,1,23.71039899,92.72001461
NAGALAND,2001,Truck/Lorry (Government),10,0,10,25.6669979,94.11657019
NAGALAND,2001,Truck/Lorry (Private),22,2,24,25.6669979,94.11657019
NAGALAND,2001,Bus (Government),1,0,1,25.6669979,94.11657019
NAGALAND,2001,Bus (Private),13,1,14,25.6669979,94.11657019
NAGALAND,2001,Tempo/Vans (Government),1,0,1,25.6669979,94.11657019
NAGALAND,2001,Tempo/Vans (Private),2,1,3,25.6669979,94.11657019
NAGALAND,2001,Jeep (Government),1,0,1,25.6669979,94.11657019
NAGALAND,2001,Jeep (Private),0,0,0,25.6669979,94.11657019
NAGALAND,2001,Car (Government),1,0,1,25.6669979,94.11657019
NAGALAND,2001,Car (Private),5,1,6,25.6669979,94.11657019
NAGALAND,2001,Three Wheeler,0,0,0,25.6669979,94.11657019
NAGALAND,2001,Two Wheeler,3,0,3,25.6669979,94.11657019
NAGALAND,2001,Bicycle,0,0,0,25.6669979,94.11657019
NAGALAND,2001,Pedestrian,0,0,0,25.6669979,94.11657019
NAGALAND,2001,Others (Please Specify),1,0,1,25.6669979,94.11657019
NAGALAND,2002,Truck/Lorry (Government),2,0,2,25.6669979,94.11657019
NAGALAND,2002,Truck/Lorry (Private),11,1,12,25.6669979,94.11657019
NAGALAND,2002,Bus (Government),0,0,0,25.6669979,94.11657019
NAGALAND,2002,Bus (Private),7,2,9,25.6669979,94.11657019
NAGALAND,2002,Tempo/Vans (Government),0,0,0,25.6669979,94.11657019
NAGALAND,2002,Tempo/Vans (Private),5,0,5,25.6669979,94.11657019
NAGALAND,2002,Jeep (Government),0,0,0,25.6669979,94.11657019
NAGALAND,2002,Jeep (Private),2,0,2,25.6669979,94.11657019
NAGALAND,2002,Car (Government),0,0,0,25.6669979,94.11657019
NAGALAND,2002,Car (Private),6,0,6,25.6669979,94.11657019
NAGALAND,2002,Three Wheeler,0,0,0,25.6669979,94.11657019
NAGALAND,2002,Two Wheeler,0,0,0,25.6669979,94.11657019
NAGALAND,2002,Bicycle,1,0,1,25.6669979,94.11657019
NAGALAND,2002,Pedestrian,1,0,1,25.6669979,94.11657019
NAGALAND,2002,Others (Please Specify),0,0,0,25.6669979,94.11657019
NAGALAND,2003,Truck/Lorry (Government),2,0,2,25.6669979,94.11657019
NAGALAND,2003,Truck/Lorry (Private),27,1,28,25.6669979,94.11657019
NAGALAND,2003,Bus (Government),0,0,0,25.6669979,94.11657019
NAGALAND,2003,Bus (Private),7,4,11,25.6669979,94.11657019
NAGALAND,2003,Tempo/Vans (Government),1,1,2,25.6669979,94.11657019
NAGALAND,2003,Tempo/Vans (Private),3,2,5,25.6669979,94.11657019
NAGALAND,2003,Jeep (Government),0,0,0,25.6669979,94.11657019
NAGALAND,2003,Jeep (Private),3,1,4,25.6669979,94.11657019
NAGALAND,2003,Car (Government),0,0,0,25.6669979,94.11657019
NAGALAND,2003,Car (Private),4,0,4,25.6669979,94.11657019
NAGALAND,2003,Three Wheeler,0,1,1,25.6669979,94.11657019
NAGALAND,2003,Two Wheeler,5,0,5,25.6669979,94.11657019
NAGALAND,2003,Bicycle,0,0,0,25.6669979,94.11657019
NAGALAND,2003,Pedestrian,3,0,3,25.6669979,94.11657019
NAGALAND,2003,Others (Please Specify),0,0,0,25.6669979,94.11657019
NAGALAND,2004,Truck/Lorry (Government),1,0,1,25.6669979,94.11657019
NAGALAND,2004,Truck/Lorry (Private),9,0,9,25.6669979,94.11657019
NAGALAND,2004,Bus (Government),16,1,17,25.6669979,94.11657019
NAGALAND,2004,Bus (Private),4,0,4,25.6669979,94.11657019
NAGALAND,2004,Tempo/Vans (Government),0,0,0,25.6669979,94.11657019
NAGALAND,2004,Tempo/Vans (Private),8,3,11,25.6669979,94.11657019
NAGALAND,2004,Jeep (Government),1,0,1,25.6669979,94.11657019
NAGALAND,2004,Jeep (Private),3,0,3,25.6669979,94.11657019
NAGALAND,2004,Car (Government),0,0,0,25.6669979,94.11657019
NAGALAND,2004,Car (Private),3,0,3,25.6669979,94.11657019
NAGALAND,2004,Three Wheeler,3,3,6,25.6669979,94.11657019
NAGALAND,2004,Two Wheeler,2,0,2,25.6669979,94.11657019
NAGALAND,2004,Bicycle,0,0,0,25.6669979,94.11657019
NAGALAND,2004,Pedestrian,2,1,3,25.6669979,94.11657019
NAGALAND,2004,Others (Please Specify),3,0,3,25.6669979,94.11657019
NAGALAND,2005,Truck/Lorry (Government),1,0,1,25.6669979,94.11657019
NAGALAND,2005,Truck/Lorry (Private),16,1,17,25.6669979,94.11657019
NAGALAND,2005,Bus (Government),0,0,0,25.6669979,94.11657019
NAGALAND,2005,Bus (Private),5,0,5,25.6669979,94.11657019
NAGALAND,2005,Tempo/Vans (Government),0,0,0,25.6669979,94.11657019
NAGALAND,2005,Tempo/Vans (Private),5,0,5,25.6669979,94.11657019
NAGALAND,2005,Jeep (Government),1,0,1,25.6669979,94.11657019
NAGALAND,2005,Jeep (Private),4,0,4,25.6669979,94.11657019
NAGALAND,2005,Car (Government),0,0,0,25.6669979,94.11657019
NAGALAND,2005,Car (Private),1,1,2,25.6669979,94.11657019
NAGALAND,2005,Three Wheeler,1,1,2,25.6669979,94.11657019
NAGALAND,2005,Two Wheeler,3,0,3,25.6669979,94.11657019
NAGALAND,2005,Bicycle,0,0,0,25.6669979,94.11657019
NAGALAND,2005,Pedestrian,0,0,0,25.6669979,94.11657019
NAGALAND,2005,Others (Please Specify),2,0,2,25.6669979,94.11657019
NAGALAND,2006,Truck/Lorry (Government),7,0,7,25.6669979,94.11657019
NAGALAND,2006,Truck/Lorry (Private),10,1,11,25.6669979,94.11657019
NAGALAND,2006,Bus (Government),0,0,0,25.6669979,94.11657019
NAGALAND,2006,Bus (Private),12,1,13,25.6669979,94.11657019
NAGALAND,2006,Tempo/Vans (Government),0,0,0,25.6669979,94.11657019
NAGALAND,2006,Tempo/Vans (Private),3,0,3,25.6669979,94.11657019
NAGALAND,2006,Jeep (Government),0,0,0,25.6669979,94.11657019
NAGALAND,2006,Jeep (Private),5,0,5,25.6669979,94.11657019
NAGALAND,2006,Car (Government),0,0,0,25.6669979,94.11657019
NAGALAND,2006,Car (Private),2,3,5,25.6669979,94.11657019
NAGALAND,2006,Three Wheeler,3,0,3,25.6669979,94.11657019
NAGALAND,2006,Two Wheeler,7,0,7,25.6669979,94.11657019
NAGALAND,2006,Bicycle,1,0,1,25.6669979,94.11657019
NAGALAND,2006,Pedestrian,5,0,5,25.6669979,94.11657019
NAGALAND,2006,Others (Please Specify),2,0,2,25.6669979,94.11657019
NAGALAND,2007,Truck/Lorry (Government),1,0,1,25.6669979,94.11657019
NAGALAND,2007,Truck/Lorry (Private),7,2,9,25.6669979,94.11657019
NAGALAND,2007,Bus (Government),9,2,11,25.6669979,94.11657019
NAGALAND,2007,Bus (Private),22,5,27,25.6669979,94.11657019
NAGALAND,2007,Tempo/Vans (Government),0,0,0,25.6669979,94.11657019
NAGALAND,2007,Tempo/Vans (Private),3,0,3,25.6669979,94.11657019
NAGALAND,2007,Jeep (Government),0,0,0,25.6669979,94.11657019
NAGALAND,2007,Jeep (Private),4,0,4,25.6669979,94.11657019
NAGALAND,2007,Car (Government),0,0,0,25.6669979,94.11657019
NAGALAND,2007,Car (Private),7,1,8,25.6669979,94.11657019
NAGALAND,2007,Three Wheeler,2,2,4,25.6669979,94.11657019
NAGALAND,2007,Two Wheeler,6,1,7,25.6669979,94.11657019
NAGALAND,2007,Bicycle,1,0,1,25.6669979,94.11657019
NAGALAND,2007,Pedestrian,10,2,12,25.6669979,94.11657019
NAGALAND,2007,Others (Please Specify),3,2,5,25.6669979,94.11657019
NAGALAND,2008,Truck/Lorry (Government),5,0,5,25.6669979,94.11657019
NAGALAND,2008,Truck/Lorry (Private),23,0,23,25.6669979,94.11657019
NAGALAND,2008,Bus (Government),16,4,20,25.6669979,94.11657019
NAGALAND,2008,Bus (Private),4,0,4,25.6669979,94.11657019
NAGALAND,2008,Tempo/Vans (Government),6,0,6,25.6669979,94.11657019
NAGALAND,2008,Tempo/Vans (Private),6,0,6,25.6669979,94.11657019
NAGALAND,2008,Jeep (Government),0,0,0,25.6669979,94.11657019
NAGALAND,2008,Jeep (Private),4,0,4,25.6669979,94.11657019
NAGALAND,2008,Car (Government),0,0,0,25.6669979,94.11657019
NAGALAND,2008,Car (Private),10,0,10,25.6669979,94.11657019
NAGALAND,2008,Three Wheeler,4,2,6,25.6669979,94.11657019
NAGALAND,2008,Two Wheeler,14,0,14,25.6669979,94.11657019
NAGALAND,2008,Bicycle,4,0,4,25.6669979,94.11657019
NAGALAND,2008,Pedestrian,8,4,12,25.6669979,94.11657019
NAGALAND,2008,Others (Please Specify),2,0,2,25.6669979,94.11657019
NAGALAND,2009,Truck/Lorry (Government),8,0,8,25.6669979,94.11657019
NAGALAND,2009,Truck/Lorry (Private),13,0,13,25.6669979,94.11657019
NAGALAND,2009,Bus (Government),0,0,0,25.6669979,94.11657019
NAGALAND,2009,Bus (Private),9,1,10,25.6669979,94.11657019
NAGALAND,2009,Tempo/Vans (Government),0,0,0,25.6669979,94.11657019
NAGALAND,2009,Tempo/Vans (Private),1,0,1,25.6669979,94.11657019
NAGALAND,2009,Jeep (Government),0,0,0,25.6669979,94.11657019
NAGALAND,2009,Jeep (Private),1,0,1,25.6669979,94.11657019
NAGALAND,2009,Car (Government),0,0,0,25.6669979,94.11657019
NAGALAND,2009,Car (Private),4,1,5,25.6669979,94.11657019
NAGALAND,2009,Three Wheeler,1,1,2,25.6669979,94.11657019
NAGALAND,2009,Two Wheeler,3,0,3,25.6669979,94.11657019
NAGALAND,2009,Bicycle,2,0,2,25.6669979,94.11657019
NAGALAND,2009,Pedestrian,2,1,3,25.6669979,94.11657019
NAGALAND,2009,Others (Please Specify),2,0,2,25.6669979,94.11657019
NAGALAND,2010,Truck/Lorry (Government),0,0,0,25.6669979,94.11657019
NAGALAND,2010,Truck/Lorry (Private),11,2,13,25.6669979,94.11657019
NAGALAND,2010,Bus (Government),1,3,4,25.6669979,94.11657019
NAGALAND,2010,Bus (Private),2,2,4,25.6669979,94.11657019
NAGALAND,2010,Tempo/Vans (Government),0,0,0,25.6669979,94.11657019
NAGALAND,2010,Tempo/Vans (Private),3,1,4,25.6669979,94.11657019
NAGALAND,2010,Jeep (Government),0,0,0,25.6669979,94.11657019
NAGALAND,2010,Jeep (Private),6,0,6,25.6669979,94.11657019
NAGALAND,2010,Car (Government),0,0,0,25.6669979,94.11657019
NAGALAND,2010,Car (Private),3,0,3,25.6669979,94.11657019
NAGALAND,2010,Three Wheeler,2,0,2,25.6669979,94.11657019
NAGALAND,2010,Two Wheeler,1,0,1,25.6669979,94.11657019
NAGALAND,2010,Bicycle,1,0,1,25.6669979,94.11657019
NAGALAND,2010,Pedestrian,4,1,5,25.6669979,94.11657019
NAGALAND,2010,Others (Please Specify),1,0,1,25.6669979,94.11657019
NAGALAND,2011,Truck/Lorry (Government),0,0,0,25.6669979,94.11657019
NAGALAND,2011,Truck/Lorry (Private),11,2,13,25.6669979,94.11657019
NAGALAND,2011,Bus (Government),0,0,0,25.6669979,94.11657019
NAGALAND,2011,Bus (Private),4,0,4,25.6669979,94.11657019
NAGALAND,2011,Tempo/Vans (Government),0,0,0,25.6669979,94.11657019
NAGALAND,2011,Tempo/Vans (Private),0,0,0,25.6669979,94.11657019
NAGALAND,2011,Jeep (Government),0,0,0,25.6669979,94.11657019
NAGALAND,2011,Jeep (Private),7,0,7,25.6669979,94.11657019
NAGALAND,2011,Car (Government),0,0,0,25.6669979,94.11657019
NAGALAND,2011,Car (Private),6,2,8,25.6669979,94.11657019
NAGALAND,2011,Three Wheeler,0,0,0,25.6669979,94.11657019
NAGALAND,2011,Two Wheeler,1,0,1,25.6669979,94.11657019
NAGALAND,2011,Bicycle,0,0,0,25.6669979,94.11657019
NAGALAND,2011,Pedestrian,0,0,0,25.6669979,94.11657019
NAGALAND,2011,Others (Please Specify),3,0,3,25.6669979,94.11657019
NAGALAND,2012,Truck/Lorry (Government),0,0,0,25.6669979,94.11657019
NAGALAND,2012,Truck/Lorry (Private),20,1,21,25.6669979,94.11657019
NAGALAND,2012,Bus (Government),0,0,0,25.6669979,94.11657019
NAGALAND,2012,Bus (Private),7,3,10,25.6669979,94.11657019
NAGALAND,2012,Tempo/Vans (Government),0,0,0,25.6669979,94.11657019
NAGALAND,2012,Tempo/Vans (Private),2,0,2,25.6669979,94.11657019
NAGALAND,2012,Jeep (Government),1,0,1,25.6669979,94.11657019
NAGALAND,2012,Jeep (Private),1,0,1,25.6669979,94.11657019
NAGALAND,2012,Car (Government),0,0,0,25.6669979,94.11657019
NAGALAND,2012,Car (Private),2,0,2,25.6669979,94.11657019
NAGALAND,2012,Three Wheeler,4,1,5,25.6669979,94.11657019
NAGALAND,2012,Two Wheeler,4,1,5,25.6669979,94.11657019
NAGALAND,2012,Bicycle,2,0,2,25.6669979,94.11657019
NAGALAND,2012,Pedestrian,5,1,6,25.6669979,94.11657019
NAGALAND,2012,Others (Please Specify),1,0,1,25.6669979,94.11657019
ODISHA,2001,Truck/Lorry (Government),10,3,13,19.82042971,85.90001746
ODISHA,2001,Truck/Lorry (Private),530,100,630,19.82042971,85.90001746
ODISHA,2001,Bus (Government),13,7,20,19.82042971,85.90001746
ODISHA,2001,Bus (Private),191,67,258,19.82042971,85.90001746
ODISHA,2001,Tempo/Vans (Government),6,1,7,19.82042971,85.90001746
ODISHA,2001,Tempo/Vans (Private),49,10,59,19.82042971,85.90001746
ODISHA,2001,Jeep (Government),14,0,14,19.82042971,85.90001746
ODISHA,2001,Jeep (Private),144,34,178,19.82042971,85.90001746
ODISHA,2001,Car (Government),0,0,0,19.82042971,85.90001746
ODISHA,2001,Car (Private),115,29,144,19.82042971,85.90001746
ODISHA,2001,Three Wheeler,31,12,43,19.82042971,85.90001746
ODISHA,2001,Two Wheeler,249,45,294,19.82042971,85.90001746
ODISHA,2001,Bicycle,27,12,39,19.82042971,85.90001746
ODISHA,2001,Pedestrian,48,9,57,19.82042971,85.90001746
ODISHA,2001,Others (Please Specify),138,46,184,19.82042971,85.90001746
ODISHA,2002,Truck/Lorry (Government),0,2,2,19.82042971,85.90001746
ODISHA,2002,Truck/Lorry (Private),587,85,672,19.82042971,85.90001746
ODISHA,2002,Bus (Government),6,1,7,19.82042971,85.90001746
ODISHA,2002,Bus (Private),242,48,290,19.82042971,85.90001746
ODISHA,2002,Tempo/Vans (Government),3,0,3,19.82042971,85.90001746
ODISHA,2002,Tempo/Vans (Private),56,8,64,19.82042971,85.90001746
ODISHA,2002,Jeep (Government),6,0,6,19.82042971,85.90001746
ODISHA,2002,Jeep (Private),140,18,158,19.82042971,85.90001746
ODISHA,2002,Car (Government),3,0,3,19.82042971,85.90001746
ODISHA,2002,Car (Private),102,33,135,19.82042971,85.90001746
ODISHA,2002,Three Wheeler,32,0,32,19.82042971,85.90001746
ODISHA,2002,Two Wheeler,328,44,372,19.82042971,85.90001746
ODISHA,2002,Bicycle,44,6,50,19.82042971,85.90001746
ODISHA,2002,Pedestrian,61,15,76,19.82042971,85.90001746
ODISHA,2002,Others (Please Specify),215,40,255,19.82042971,85.90001746
ODISHA,2003,Truck/Lorry (Government),39,20,59,19.82042971,85.90001746
ODISHA,2003,Truck/Lorry (Private),640,101,741,19.82042971,85.90001746
ODISHA,2003,Bus (Government),3,1,4,19.82042971,85.90001746
ODISHA,2003,Bus (Private),195,51,246,19.82042971,85.90001746
ODISHA,2003,Tempo/Vans (Government),2,0,2,19.82042971,85.90001746
ODISHA,2003,Tempo/Vans (Private),33,7,40,19.82042971,85.90001746
ODISHA,2003,Jeep (Government),3,2,5,19.82042971,85.90001746
ODISHA,2003,Jeep (Private),195,32,227,19.82042971,85.90001746
ODISHA,2003,Car (Government),0,0,0,19.82042971,85.90001746
ODISHA,2003,Car (Private),105,19,124,19.82042971,85.90001746
ODISHA,2003,Three Wheeler,49,11,60,19.82042971,85.90001746
ODISHA,2003,Two Wheeler,304,63,367,19.82042971,85.90001746
ODISHA,2003,Bicycle,35,5,40,19.82042971,85.90001746
ODISHA,2003,Pedestrian,65,15,80,19.82042971,85.90001746
ODISHA,2003,Others (Please Specify),273,53,326,19.82042971,85.90001746
ODISHA,2004,Truck/Lorry (Government),29,2,31,19.82042971,85.90001746
ODISHA,2004,Truck/Lorry (Private),755,133,888,19.82042971,85.90001746
ODISHA,2004,Bus (Government),2,0,2,19.82042971,85.90001746
ODISHA,2004,Bus (Private),225,67,292,19.82042971,85.90001746
ODISHA,2004,Tempo/Vans (Government),5,0,5,19.82042971,85.90001746
ODISHA,2004,Tempo/Vans (Private),61,16,77,19.82042971,85.90001746
ODISHA,2004,Jeep (Government),3,0,3,19.82042971,85.90001746
ODISHA,2004,Jeep (Private),166,48,214,19.82042971,85.90001746
ODISHA,2004,Car (Government),0,0,0,19.82042971,85.90001746
ODISHA,2004,Car (Private),121,38,159,19.82042971,85.90001746
ODISHA,2004,Three Wheeler,61,15,76,19.82042971,85.90001746
ODISHA,2004,Two Wheeler,313,66,379,19.82042971,85.90001746
ODISHA,2004,Bicycle,32,5,37,19.82042971,85.90001746
ODISHA,2004,Pedestrian,73,11,84,19.82042971,85.90001746
ODISHA,2004,Others (Please Specify),187,38,225,19.82042971,85.90001746
ODISHA,2005,Truck/Lorry (Government),1,0,1,19.82042971,85.90001746
ODISHA,2005,Truck/Lorry (Private),784,272,1056,19.82042971,85.90001746
ODISHA,2005,Bus (Government),3,0,3,19.82042971,85.90001746
ODISHA,2005,Bus (Private),208,69,277,19.82042971,85.90001746
ODISHA,2005,Tempo/Vans (Government),11,0,11,19.82042971,85.90001746
ODISHA,2005,Tempo/Vans (Private),100,28,128,19.82042971,85.90001746
ODISHA,2005,Jeep (Government),10,1,11,19.82042971,85.90001746
ODISHA,2005,Jeep (Private),140,33,173,19.82042971,85.90001746
ODISHA,2005,Car (Government),2,0,2,19.82042971,85.90001746
ODISHA,2005,Car (Private),215,61,276,19.82042971,85.90001746
ODISHA,2005,Three Wheeler,43,8,51,19.82042971,85.90001746
ODISHA,2005,Two Wheeler,428,76,504,19.82042971,85.90001746
ODISHA,2005,Bicycle,36,3,39,19.82042971,85.90001746
ODISHA,2005,Pedestrian,52,5,57,19.82042971,85.90001746
ODISHA,2005,Others (Please Specify),261,45,306,19.82042971,85.90001746
ODISHA,2006,Truck/Lorry (Government),24,0,24,19.82042971,85.90001746
ODISHA,2006,Truck/Lorry (Private),786,139,925,19.82042971,85.90001746
ODISHA,2006,Bus (Government),1,1,2,19.82042971,85.90001746
ODISHA,2006,Bus (Private),259,103,362,19.82042971,85.90001746
ODISHA,2006,Tempo/Vans (Government),1,5,6,19.82042971,85.90001746
ODISHA,2006,Tempo/Vans (Private),114,25,139,19.82042971,85.90001746
ODISHA,2006,Jeep (Government),1,0,1,19.82042971,85.90001746
ODISHA,2006,Jeep (Private),152,32,184,19.82042971,85.90001746
ODISHA,2006,Car (Government),0,0,0,19.82042971,85.90001746
ODISHA,2006,Car (Private),209,44,253,19.82042971,85.90001746
ODISHA,2006,Three Wheeler,43,14,57,19.82042971,85.90001746
ODISHA,2006,Two Wheeler,414,71,485,19.82042971,85.90001746
ODISHA,2006,Bicycle,19,2,21,19.82042971,85.90001746
ODISHA,2006,Pedestrian,37,6,43,19.82042971,85.90001746
ODISHA,2006,Others (Please Specify),199,44,243,19.82042971,85.90001746
ODISHA,2007,Truck/Lorry (Government),5,3,8,19.82042971,85.90001746
ODISHA,2007,Truck/Lorry (Private),982,144,1126,19.82042971,85.90001746
ODISHA,2007,Bus (Government),4,0,4,19.82042971,85.90001746
ODISHA,2007,Bus (Private),225,68,293,19.82042971,85.90001746
ODISHA,2007,Tempo/Vans (Government),5,0,5,19.82042971,85.90001746
ODISHA,2007,Tempo/Vans (Private),92,28,120,19.82042971,85.90001746
ODISHA,2007,Jeep (Government),4,0,4,19.82042971,85.90001746
ODISHA,2007,Jeep (Private),127,32,159,19.82042971,85.90001746
ODISHA,2007,Car (Government),0,1,1,19.82042971,85.90001746
ODISHA,2007,Car (Private),217,61,278,19.82042971,85.90001746
ODISHA,2007,Three Wheeler,38,8,46,19.82042971,85.90001746
ODISHA,2007,Two Wheeler,520,119,639,19.82042971,85.90001746
ODISHA,2007,Bicycle,25,4,29,19.82042971,85.90001746
ODISHA,2007,Pedestrian,58,16,74,19.82042971,85.90001746
ODISHA,2007,Others (Please Specify),216,56,272,19.82042971,85.90001746
ODISHA,2008,Truck/Lorry (Government),2,0,2,19.82042971,85.90001746
ODISHA,2008,Truck/Lorry (Private),943,106,1049,19.82042971,85.90001746
ODISHA,2008,Bus (Government),8,3,11,19.82042971,85.90001746
ODISHA,2008,Bus (Private),260,70,330,19.82042971,85.90001746
ODISHA,2008,Tempo/Vans (Government),0,0,0,19.82042971,85.90001746
ODISHA,2008,Tempo/Vans (Private),117,27,144,19.82042971,85.90001746
ODISHA,2008,Jeep (Government),4,1,5,19.82042971,85.90001746
ODISHA,2008,Jeep (Private),148,16,164,19.82042971,85.90001746
ODISHA,2008,Car (Government),1,1,2,19.82042971,85.90001746
ODISHA,2008,Car (Private),200,39,239,19.82042971,85.90001746
ODISHA,2008,Three Wheeler,66,15,81,19.82042971,85.90001746
ODISHA,2008,Two Wheeler,423,92,515,19.82042971,85.90001746
ODISHA,2008,Bicycle,41,6,47,19.82042971,85.90001746
ODISHA,2008,Pedestrian,97,33,130,19.82042971,85.90001746
ODISHA,2008,Others (Please Specify),350,35,385,19.82042971,85.90001746
ODISHA,2009,Truck/Lorry (Government),4,2,6,19.82042971,85.90001746
ODISHA,2009,Truck/Lorry (Private),942,95,1037,19.82042971,85.90001746
ODISHA,2009,Bus (Government),4,2,6,19.82042971,85.90001746
ODISHA,2009,Bus (Private),323,72,395,19.82042971,85.90001746
ODISHA,2009,Tempo/Vans (Government),0,1,1,19.82042971,85.90001746
ODISHA,2009,Tempo/Vans (Private),150,23,173,19.82042971,85.90001746
ODISHA,2009,Jeep (Government),7,1,8,19.82042971,85.90001746
ODISHA,2009,Jeep (Private),176,27,203,19.82042971,85.90001746
ODISHA,2009,Car (Government),0,0,0,19.82042971,85.90001746
ODISHA,2009,Car (Private),175,45,220,19.82042971,85.90001746
ODISHA,2009,Three Wheeler,79,15,94,19.82042971,85.90001746
ODISHA,2009,Two Wheeler,613,102,715,19.82042971,85.90001746
ODISHA,2009,Bicycle,44,5,49,19.82042971,85.90001746
ODISHA,2009,Pedestrian,113,34,147,19.82042971,85.90001746
ODISHA,2009,Others (Please Specify),408,87,495,19.82042971,85.90001746
ODISHA,2010,Truck/Lorry (Government),48,14,62,19.82042971,85.90001746
ODISHA,2010,Truck/Lorry (Private),1275,179,1454,19.82042971,85.90001746
ODISHA,2010,Bus (Government),7,1,8,19.82042971,85.90001746
ODISHA,2010,Bus (Private),251,73,324,19.82042971,85.90001746
ODISHA,2010,Tempo/Vans (Government),2,0,2,19.82042971,85.90001746
ODISHA,2010,Tempo/Vans (Private),136,39,175,19.82042971,85.90001746
ODISHA,2010,Jeep (Government),1,0,1,19.82042971,85.90001746
ODISHA,2010,Jeep (Private),163,37,200,19.82042971,85.90001746
ODISHA,2010,Car (Government),1,0,1,19.82042971,85.90001746
ODISHA,2010,Car (Private),262,62,324,19.82042971,85.90001746
ODISHA,2010,Three Wheeler,93,35,128,19.82042971,85.90001746
ODISHA,2010,Two Wheeler,596,110,706,19.82042971,85.90001746
ODISHA,2010,Bicycle,45,4,49,19.82042971,85.90001746
ODISHA,2010,Pedestrian,100,17,117,19.82042971,85.90001746
ODISHA,2010,Others (Please Specify),480,74,554,19.82042971,85.90001746
ODISHA,2011,Truck/Lorry (Government),1,0,1,19.82042971,85.90001746
ODISHA,2011,Truck/Lorry (Private),1074,86,1160,19.82042971,85.90001746
ODISHA,2011,Bus (Government),11,2,13,19.82042971,85.90001746
ODISHA,2011,Bus (Private),334,92,426,19.82042971,85.90001746
ODISHA,2011,Tempo/Vans (Government),7,0,7,19.82042971,85.90001746
ODISHA,2011,Tempo/Vans (Private),205,65,270,19.82042971,85.90001746
ODISHA,2011,Jeep (Government),3,0,3,19.82042971,85.90001746
ODISHA,2011,Jeep (Private),164,37,201,19.82042971,85.90001746
ODISHA,2011,Car (Government),6,3,9,19.82042971,85.90001746
ODISHA,2011,Car (Private),249,70,319,19.82042971,85.90001746
ODISHA,2011,Three Wheeler,83,26,109,19.82042971,85.90001746
ODISHA,2011,Two Wheeler,482,105,587,19.82042971,85.90001746
ODISHA,2011,Bicycle,31,3,34,19.82042971,85.90001746
ODISHA,2011,Pedestrian,66,16,82,19.82042971,85.90001746
ODISHA,2011,Others (Please Specify),482,94,576,19.82042971,85.90001746
ODISHA,2012,Truck/Lorry (Government),9,6,15,19.82042971,85.90001746
ODISHA,2012,Truck/Lorry (Private),1004,86,1090,19.82042971,85.90001746
ODISHA,2012,Bus (Government),1,0,1,19.82042971,85.90001746
ODISHA,2012,Bus (Private),241,71,312,19.82042971,85.90001746
ODISHA,2012,Tempo/Vans (Government),9,0,9,19.82042971,85.90001746
ODISHA,2012,Tempo/Vans (Private),201,37,238,19.82042971,85.90001746
ODISHA,2012,Jeep (Government),0,0,0,19.82042971,85.90001746
ODISHA,2012,Jeep (Private),114,30,144,19.82042971,85.90001746
ODISHA,2012,Car (Government),1,1,2,19.82042971,85.90001746
ODISHA,2012,Car (Private),284,60,344,19.82042971,85.90001746
ODISHA,2012,Three Wheeler,138,25,163,19.82042971,85.90001746
ODISHA,2012,Two Wheeler,685,119,804,19.82042971,85.90001746
ODISHA,2012,Bicycle,56,8,64,19.82042971,85.90001746
ODISHA,2012,Pedestrian,95,24,119,19.82042971,85.90001746
ODISHA,2012,Others (Please Specify),323,73,396,19.82042971,85.90001746
PUNJAB,2001,Truck/Lorry (Government),10,0,10,31.51997398,75.98000281
PUNJAB,2001,Truck/Lorry (Private),276,33,309,31.51997398,75.98000281
PUNJAB,2001,Bus (Government),83,19,102,31.51997398,75.98000281
PUNJAB,2001,Bus (Private),137,19,156,31.51997398,75.98000281
PUNJAB,2001,Tempo/Vans (Government),1,0,1,31.51997398,75.98000281
PUNJAB,2001,Tempo/Vans (Private),119,19,138,31.51997398,75.98000281
PUNJAB,2001,Jeep (Government),22,4,26,31.51997398,75.98000281
PUNJAB,2001,Jeep (Private),72,19,91,31.51997398,75.98000281
PUNJAB,2001,Car (Government),13,3,16,31.51997398,75.98000281
PUNJAB,2001,Car (Private),127,23,150,31.51997398,75.98000281
PUNJAB,2001,Three Wheeler,40,11,51,31.51997398,75.98000281
PUNJAB,2001,Two Wheeler,218,19,237,31.51997398,75.98000281
PUNJAB,2001,Bicycle,55,7,62,31.51997398,75.98000281
PUNJAB,2001,Pedestrian,62,8,70,31.51997398,75.98000281
PUNJAB,2001,Others (Please Specify),65,25,90,31.51997398,75.98000281
PUNJAB,2002,Truck/Lorry (Government),6,0,6,31.51997398,75.98000281
PUNJAB,2002,Truck/Lorry (Private),295,23,318,31.51997398,75.98000281
PUNJAB,2002,Bus (Government),73,9,82,31.51997398,75.98000281
PUNJAB,2002,Bus (Private),135,28,163,31.51997398,75.98000281
PUNJAB,2002,Tempo/Vans (Government),0,0,0,31.51997398,75.98000281
PUNJAB,2002,Tempo/Vans (Private),133,14,147,31.51997398,75.98000281
PUNJAB,2002,Jeep (Government),4,3,7,31.51997398,75.98000281
PUNJAB,2002,Jeep (Private),99,15,114,31.51997398,75.98000281
PUNJAB,2002,Car (Government),191,36,227,31.51997398,75.98000281
PUNJAB,2002,Car (Private),7,1,8,31.51997398,75.98000281
PUNJAB,2002,Three Wheeler,118,22,140,31.51997398,75.98000281
PUNJAB,2002,Two Wheeler,3,0,3,31.51997398,75.98000281
PUNJAB,2002,Bicycle,221,18,239,31.51997398,75.98000281
PUNJAB,2002,Pedestrian,68,3,71,31.51997398,75.98000281
PUNJAB,2002,Others (Please Specify),82,1,83,31.51997398,75.98000281
PUNJAB,2003,Truck/Lorry (Government),17,0,17,31.51997398,75.98000281
PUNJAB,2003,Truck/Lorry (Private),362,14,376,31.51997398,75.98000281
PUNJAB,2003,Bus (Government),49,11,60,31.51997398,75.98000281
PUNJAB,2003,Bus (Private),132,22,154,31.51997398,75.98000281
PUNJAB,2003,Tempo/Vans (Government),1,0,1,31.51997398,75.98000281
PUNJAB,2003,Tempo/Vans (Private),113,12,125,31.51997398,75.98000281
PUNJAB,2003,Jeep (Government),0,0,0,31.51997398,75.98000281
PUNJAB,2003,Jeep (Private),84,14,98,31.51997398,75.98000281
PUNJAB,2003,Car (Government),13,1,14,31.51997398,75.98000281
PUNJAB,2003,Car (Private),183,24,207,31.51997398,75.98000281
PUNJAB,2003,Three Wheeler,40,17,57,31.51997398,75.98000281
PUNJAB,2003,Two Wheeler,245,25,270,31.51997398,75.98000281
PUNJAB,2003,Bicycle,54,1,55,31.51997398,75.98000281
PUNJAB,2003,Pedestrian,39,1,40,31.51997398,75.98000281
PUNJAB,2003,Others (Please Specify),73,10,83,31.51997398,75.98000281
PUNJAB,2004,Truck/Lorry (Government),31,2,33,31.51997398,75.98000281
PUNJAB,2004,Truck/Lorry (Private),305,17,322,31.51997398,75.98000281
PUNJAB,2004,Bus (Government),61,10,71,31.51997398,75.98000281
PUNJAB,2004,Bus (Private),142,15,157,31.51997398,75.98000281
PUNJAB,2004,Tempo/Vans (Government),6,0,6,31.51997398,75.98000281
PUNJAB,2004,Tempo/Vans (Private),143,9,152,31.51997398,75.98000281
PUNJAB,2004,Jeep (Government),0,0,0,31.51997398,75.98000281
PUNJAB,2004,Jeep (Private),80,8,88,31.51997398,75.98000281
PUNJAB,2004,Car (Government),23,2,25,31.51997398,75.98000281
PUNJAB,2004,Car (Private),218,22,240,31.51997398,75.98000281
PUNJAB,2004,Three Wheeler,30,9,39,31.51997398,75.98000281
PUNJAB,2004,Two Wheeler,334,73,407,31.51997398,75.98000281
PUNJAB,2004,Bicycle,87,7,94,31.51997398,75.98000281
PUNJAB,2004,Pedestrian,66,5,71,31.51997398,75.98000281
PUNJAB,2004,Others (Please Specify),130,20,150,31.51997398,75.98000281
PUNJAB,2005,Truck/Lorry (Government),33,3,36,31.51997398,75.98000281
PUNJAB,2005,Truck/Lorry (Private),256,29,285,31.51997398,75.98000281
PUNJAB,2005,Bus (Government),57,11,68,31.51997398,75.98000281
PUNJAB,2005,Bus (Private),114,33,147,31.51997398,75.98000281
PUNJAB,2005,Tempo/Vans (Government),0,0,0,31.51997398,75.98000281
PUNJAB,2005,Tempo/Vans (Private),140,16,156,31.51997398,75.98000281
PUNJAB,2005,Jeep (Government),1,0,1,31.51997398,75.98000281
PUNJAB,2005,Jeep (Private),69,14,83,31.51997398,75.98000281
PUNJAB,2005,Car (Government),4,2,6,31.51997398,75.98000281
PUNJAB,2005,Car (Private),240,40,280,31.51997398,75.98000281
PUNJAB,2005,Three Wheeler,46,7,53,31.51997398,75.98000281
PUNJAB,2005,Two Wheeler,0,0,0,31.51997398,75.98000281
PUNJAB,2005,Bicycle,377,37,414,31.51997398,75.98000281
PUNJAB,2005,Pedestrian,0,0,0,31.51997398,75.98000281
PUNJAB,2005,Others (Please Specify),83,10,93,31.51997398,75.98000281
PUNJAB,2006,Truck/Lorry (Government),3,0,3,31.51997398,75.98000281
PUNJAB,2006,Truck/Lorry (Private),328,49,377,31.51997398,75.98000281
PUNJAB,2006,Bus (Government),37,8,45,31.51997398,75.98000281
PUNJAB,2006,Bus (Private),115,40,155,31.51997398,75.98000281
PUNJAB,2006,Tempo/Vans (Government),0,0,0,31.51997398,75.98000281
PUNJAB,2006,Tempo/Vans (Private),103,9,112,31.51997398,75.98000281
PUNJAB,2006,Jeep (Government),3,2,5,31.51997398,75.98000281
PUNJAB,2006,Jeep (Private),85,11,96,31.51997398,75.98000281
PUNJAB,2006,Car (Government),5,0,5,31.51997398,75.98000281
PUNJAB,2006,Car (Private),253,53,306,31.51997398,75.98000281
PUNJAB,2006,Three Wheeler,47,5,52,31.51997398,75.98000281
PUNJAB,2006,Two Wheeler,415,58,473,31.51997398,75.98000281
PUNJAB,2006,Bicycle,76,5,81,31.51997398,75.98000281
PUNJAB,2006,Pedestrian,64,12,76,31.51997398,75.98000281
PUNJAB,2006,Others (Please Specify),232,30,262,31.51997398,75.98000281
PUNJAB,2007,Truck/Lorry (Government),1,0,1,31.51997398,75.98000281
PUNJAB,2007,Truck/Lorry (Private),348,17,365,31.51997398,75.98000281
PUNJAB,2007,Bus (Government),54,14,68,31.51997398,75.98000281
PUNJAB,2007,Bus (Private),151,19,170,31.51997398,75.98000281
PUNJAB,2007,Tempo/Vans (Government),5,0,5,31.51997398,75.98000281
PUNJAB,2007,Tempo/Vans (Private),118,13,131,31.51997398,75.98000281
PUNJAB,2007,Jeep (Government),3,0,3,31.51997398,75.98000281
PUNJAB,2007,Jeep (Private),90,13,103,31.51997398,75.98000281
PUNJAB,2007,Car (Government),0,0,0,31.51997398,75.98000281
PUNJAB,2007,Car (Private),298,49,347,31.51997398,75.98000281
PUNJAB,2007,Three Wheeler,32,11,43,31.51997398,75.98000281
PUNJAB,2007,Two Wheeler,422,61,483,31.51997398,75.98000281
PUNJAB,2007,Bicycle,89,4,93,31.51997398,75.98000281
PUNJAB,2007,Pedestrian,95,18,113,31.51997398,75.98000281
PUNJAB,2007,Others (Please Specify),213,17,230,31.51997398,75.98000281
PUNJAB,2008,Truck/Lorry (Government),7,1,8,31.51997398,75.98000281
PUNJAB,2008,Truck/Lorry (Private),293,36,329,31.51997398,75.98000281
PUNJAB,2008,Bus (Government),27,6,33,31.51997398,75.98000281
PUNJAB,2008,Bus (Private),161,16,177,31.51997398,75.98000281
PUNJAB,2008,Tempo/Vans (Government),0,0,0,31.51997398,75.98000281
PUNJAB,2008,Tempo/Vans (Private),83,7,90,31.51997398,75.98000281
PUNJAB,2008,Jeep (Government),1,0,1,31.51997398,75.98000281
PUNJAB,2008,Jeep (Private),81,10,91,31.51997398,75.98000281
PUNJAB,2008,Car (Government),8,0,8,31.51997398,75.98000281
PUNJAB,2008,Car (Private),248,37,285,31.51997398,75.98000281
PUNJAB,2008,Three Wheeler,48,7,55,31.51997398,75.98000281
PUNJAB,2008,Two Wheeler,436,51,487,31.51997398,75.98000281
PUNJAB,2008,Bicycle,77,9,86,31.51997398,75.98000281
PUNJAB,2008,Pedestrian,116,15,131,31.51997398,75.98000281
PUNJAB,2008,Others (Please Specify),243,31,274,31.51997398,75.98000281
PUNJAB,2009,Truck/Lorry (Government),3,0,3,31.51997398,75.98000281
PUNJAB,2009,Truck/Lorry (Private),349,36,385,31.51997398,75.98000281
PUNJAB,2009,Bus (Government),37,9,46,31.51997398,75.98000281
PUNJAB,2009,Bus (Private),156,15,171,31.51997398,75.98000281
PUNJAB,2009,Tempo/Vans (Government),1,0,1,31.51997398,75.98000281
PUNJAB,2009,Tempo/Vans (Private),110,11,121,31.51997398,75.98000281
PUNJAB,2009,Jeep (Government),3,2,5,31.51997398,75.98000281
PUNJAB,2009,Jeep (Private),113,11,124,31.51997398,75.98000281
PUNJAB,2009,Car (Government),0,2,2,31.51997398,75.98000281
PUNJAB,2009,Car (Private),348,49,397,31.51997398,75.98000281
PUNJAB,2009,Three Wheeler,39,6,45,31.51997398,75.98000281
PUNJAB,2009,Two Wheeler,542,65,607,31.51997398,75.98000281
PUNJAB,2009,Bicycle,85,0,85,31.51997398,75.98000281
PUNJAB,2009,Pedestrian,139,17,156,31.51997398,75.98000281
PUNJAB,2009,Others (Please Specify),225,19,244,31.51997398,75.98000281
PUNJAB,2010,Truck/Lorry (Government),2,1,3,31.51997398,75.98000281
PUNJAB,2010,Truck/Lorry (Private),231,38,269,31.51997398,75.98000281
PUNJAB,2010,Bus (Government),24,2,26,31.51997398,75.98000281
PUNJAB,2010,Bus (Private),134,36,170,31.51997398,75.98000281
PUNJAB,2010,Tempo/Vans (Government),7,1,8,31.51997398,75.98000281
PUNJAB,2010,Tempo/Vans (Private),121,20,141,31.51997398,75.98000281
PUNJAB,2010,Jeep (Government),1,0,1,31.51997398,75.98000281
PUNJAB,2010,Jeep (Private),89,12,101,31.51997398,75.98000281
PUNJAB,2010,Car (Government),2,0,2,31.51997398,75.98000281
PUNJAB,2010,Car (Private),324,44,368,31.51997398,75.98000281
PUNJAB,2010,Three Wheeler,58,5,63,31.51997398,75.98000281
PUNJAB,2010,Two Wheeler,448,52,500,31.51997398,75.98000281
PUNJAB,2010,Bicycle,68,1,69,31.51997398,75.98000281
PUNJAB,2010,Pedestrian,73,5,78,31.51997398,75.98000281
PUNJAB,2010,Others (Please Specify),299,35,334,31.51997398,75.98000281
PUNJAB,2011,Truck/Lorry (Government),12,8,20,31.51997398,75.98000281
PUNJAB,2011,Truck/Lorry (Private),743,75,818,31.51997398,75.98000281
PUNJAB,2011,Bus (Government),89,16,105,31.51997398,75.98000281
PUNJAB,2011,Bus (Private),270,66,336,31.51997398,75.98000281
PUNJAB,2011,Tempo/Vans (Government),2,1,3,31.51997398,75.98000281
PUNJAB,2011,Tempo/Vans (Private),259,37,296,31.51997398,75.98000281
PUNJAB,2011,Jeep (Government),8,0,8,31.51997398,75.98000281
PUNJAB,2011,Jeep (Private),265,45,310,31.51997398,75.98000281
PUNJAB,2011,Car (Government),13,5,18,31.51997398,75.98000281
PUNJAB,2011,Car (Private),672,127,799,31.51997398,75.98000281
PUNJAB,2011,Three Wheeler,58,12,70,31.51997398,75.98000281
PUNJAB,2011,Two Wheeler,1044,132,1176,31.51997398,75.98000281
PUNJAB,2011,Bicycle,146,8,154,31.51997398,75.98000281
PUNJAB,2011,Pedestrian,218,24,242,31.51997398,75.98000281
PUNJAB,2011,Others (Please Specify),485,57,542,31.51997398,75.98000281
PUNJAB,2012,Truck/Lorry (Government),19,10,29,31.51997398,75.98000281
PUNJAB,2012,Truck/Lorry (Private),643,126,769,31.51997398,75.98000281
PUNJAB,2012,Bus (Government),91,34,125,31.51997398,75.98000281
PUNJAB,2012,Bus (Private),199,58,257,31.51997398,75.98000281
PUNJAB,2012,Tempo/Vans (Government),4,0,4,31.51997398,75.98000281
PUNJAB,2012,Tempo/Vans (Private),254,53,307,31.51997398,75.98000281
PUNJAB,2012,Jeep (Government),6,0,6,31.51997398,75.98000281
PUNJAB,2012,Jeep (Private),218,55,273,31.51997398,75.98000281
PUNJAB,2012,Car (Government),5,2,7,31.51997398,75.98000281
PUNJAB,2012,Car (Private),631,139,770,31.51997398,75.98000281
PUNJAB,2012,Three Wheeler,85,13,98,31.51997398,75.98000281
PUNJAB,2012,Two Wheeler,1034,115,1149,31.51997398,75.98000281
PUNJAB,2012,Bicycle,135,8,143,31.51997398,75.98000281
PUNJAB,2012,Pedestrian,209,43,252,31.51997398,75.98000281
PUNJAB,2012,Others (Please Specify),504,102,606,31.51997398,75.98000281
RAJASTHAN,2001,Truck/Lorry (Government),7,0,7,26.44999921,74.63998124
RAJASTHAN,2001,Truck/Lorry (Private),1239,139,1378,26.44999921,74.63998124
RAJASTHAN,2001,Bus (Government),102,17,119,26.44999921,74.63998124
RAJASTHAN,2001,Bus (Private),362,93,455,26.44999921,74.63998124
RAJASTHAN,2001,Tempo/Vans (Government),0,0,0,26.44999921,74.63998124
RAJASTHAN,2001,Tempo/Vans (Private),79,25,104,26.44999921,74.63998124
RAJASTHAN,2001,Jeep (Government),12,0,12,26.44999921,74.63998124
RAJASTHAN,2001,Jeep (Private),994,232,1226,26.44999921,74.63998124
RAJASTHAN,2001,Car (Government),1,0,1,26.44999921,74.63998124
RAJASTHAN,2001,Car (Private),189,62,251,26.44999921,74.63998124
RAJASTHAN,2001,Three Wheeler,58,16,74,26.44999921,74.63998124
RAJASTHAN,2001,Two Wheeler,459,75,534,26.44999921,74.63998124
RAJASTHAN,2001,Bicycle,116,0,116,26.44999921,74.63998124
RAJASTHAN,2001,Pedestrian,346,103,449,26.44999921,74.63998124
RAJASTHAN,2001,Others (Please Specify),394,67,461,26.44999921,74.63998124
RAJASTHAN,2002,Truck/Lorry (Government),19,0,19,26.44999921,74.63998124
RAJASTHAN,2002,Truck/Lorry (Private),1369,136,1505,26.44999921,74.63998124
RAJASTHAN,2002,Bus (Government),113,22,135,26.44999921,74.63998124
RAJASTHAN,2002,Bus (Private),421,90,511,26.44999921,74.63998124
RAJASTHAN,2002,Tempo/Vans (Government),0,0,0,26.44999921,74.63998124
RAJASTHAN,2002,Tempo/Vans (Private),70,10,80,26.44999921,74.63998124
RAJASTHAN,2002,Jeep (Government),15,0,15,26.44999921,74.63998124
RAJASTHAN,2002,Jeep (Private),890,202,1092,26.44999921,74.63998124
RAJASTHAN,2002,Car (Government),2,0,2,26.44999921,74.63998124
RAJASTHAN,2002,Car (Private),173,50,223,26.44999921,74.63998124
RAJASTHAN,2002,Three Wheeler,62,15,77,26.44999921,74.63998124
RAJASTHAN,2002,Two Wheeler,551,117,668,26.44999921,74.63998124
RAJASTHAN,2002,Bicycle,134,10,144,26.44999921,74.63998124
RAJASTHAN,2002,Pedestrian,378,97,475,26.44999921,74.63998124
RAJASTHAN,2002,Others (Please Specify),515,74,589,26.44999921,74.63998124
RAJASTHAN,2003,Truck/Lorry (Government),54,3,57,26.44999921,74.63998124
RAJASTHAN,2003,Truck/Lorry (Private),1484,116,1600,26.44999921,74.63998124
RAJASTHAN,2003,Bus (Government),55,19,74,26.44999921,74.63998124
RAJASTHAN,2003,Bus (Private),428,97,525,26.44999921,74.63998124
RAJASTHAN,2003,Tempo/Vans (Government),1,0,1,26.44999921,74.63998124
RAJASTHAN,2003,Tempo/Vans (Private),70,24,94,26.44999921,74.63998124
RAJASTHAN,2003,Jeep (Government),3,4,7,26.44999921,74.63998124
RAJASTHAN,2003,Jeep (Private),895,233,1128,26.44999921,74.63998124
RAJASTHAN,2003,Car (Government),2,0,2,26.44999921,74.63998124
RAJASTHAN,2003,Car (Private),211,54,265,26.44999921,74.63998124
RAJASTHAN,2003,Three Wheeler,95,25,120,26.44999921,74.63998124
RAJASTHAN,2003,Two Wheeler,611,107,718,26.44999921,74.63998124
RAJASTHAN,2003,Bicycle,113,7,120,26.44999921,74.63998124
RAJASTHAN,2003,Pedestrian,431,118,549,26.44999921,74.63998124
RAJASTHAN,2003,Others (Please Specify),654,111,765,26.44999921,74.63998124
RAJASTHAN,2004,Truck/Lorry (Government),97,9,106,26.44999921,74.63998124
RAJASTHAN,2004,Truck/Lorry (Private),1365,107,1472,26.44999921,74.63998124
RAJASTHAN,2004,Bus (Government),48,6,54,26.44999921,74.63998124
RAJASTHAN,2004,Bus (Private),389,63,452,26.44999921,74.63998124
RAJASTHAN,2004,Tempo/Vans (Government),0,0,0,26.44999921,74.63998124
RAJASTHAN,2004,Tempo/Vans (Private),115,31,146,26.44999921,74.63998124
RAJASTHAN,2004,Jeep (Government),8,1,9,26.44999921,74.63998124
RAJASTHAN,2004,Jeep (Private),942,208,1150,26.44999921,74.63998124
RAJASTHAN,2004,Car (Government),13,0,13,26.44999921,74.63998124
RAJASTHAN,2004,Car (Private),315,41,356,26.44999921,74.63998124
RAJASTHAN,2004,Three Wheeler,115,23,138,26.44999921,74.63998124
RAJASTHAN,2004,Two Wheeler,879,130,1009,26.44999921,74.63998124
RAJASTHAN,2004,Bicycle,178,37,215,26.44999921,74.63998124
RAJASTHAN,2004,Pedestrian,488,90,578,26.44999921,74.63998124
RAJASTHAN,2004,Others (Please Specify),675,104,779,26.44999921,74.63998124
RAJASTHAN,2005,Truck/Lorry (Government),23,8,31,26.44999921,74.63998124
RAJASTHAN,2005,Truck/Lorry (Private),1646,160,1806,26.44999921,74.63998124
RAJASTHAN,2005,Bus (Government),70,14,84,26.44999921,74.63998124
RAJASTHAN,2005,Bus (Private),413,94,507,26.44999921,74.63998124
RAJASTHAN,2005,Tempo/Vans (Government),0,0,0,26.44999921,74.63998124
RAJASTHAN,2005,Tempo/Vans (Private),110,22,132,26.44999921,74.63998124
RAJASTHAN,2005,Jeep (Government),44,6,50,26.44999921,74.63998124
RAJASTHAN,2005,Jeep (Private),922,206,1128,26.44999921,74.63998124
RAJASTHAN,2005,Car (Government),8,1,9,26.44999921,74.63998124
RAJASTHAN,2005,Car (Private),264,48,312,26.44999921,74.63998124
RAJASTHAN,2005,Three Wheeler,119,23,142,26.44999921,74.63998124
RAJASTHAN,2005,Two Wheeler,775,178,953,26.44999921,74.63998124
RAJASTHAN,2005,Bicycle,82,1,83,26.44999921,74.63998124
RAJASTHAN,2005,Pedestrian,478,70,548,26.44999921,74.63998124
RAJASTHAN,2005,Others (Please Specify),882,126,1008,26.44999921,74.63998124
RAJASTHAN,2006,Truck/Lorry (Government),15,5,20,26.44999921,74.63998124
RAJASTHAN,2006,Truck/Lorry (Private),1435,136,1571,26.44999921,74.63998124
RAJASTHAN,2006,Bus (Government),91,18,109,26.44999921,74.63998124
RAJASTHAN,2006,Bus (Private),388,122,510,26.44999921,74.63998124
RAJASTHAN,2006,Tempo/Vans (Government),0,0,0,26.44999921,74.63998124
RAJASTHAN,2006,Tempo/Vans (Private),26,8,34,26.44999921,74.63998124
RAJASTHAN,2006,Jeep (Government),7,0,7,26.44999921,74.63998124
RAJASTHAN,2006,Jeep (Private),1096,275,1371,26.44999921,74.63998124
RAJASTHAN,2006,Car (Government),2,0,2,26.44999921,74.63998124
RAJASTHAN,2006,Car (Private),284,84,368,26.44999921,74.63998124
RAJASTHAN,2006,Three Wheeler,194,18,212,26.44999921,74.63998124
RAJASTHAN,2006,Two Wheeler,939,170,1109,26.44999921,74.63998124
RAJASTHAN,2006,Bicycle,113,7,120,26.44999921,74.63998124
RAJASTHAN,2006,Pedestrian,653,132,785,26.44999921,74.63998124
RAJASTHAN,2006,Others (Please Specify),802,134,936,26.44999921,74.63998124
RAJASTHAN,2007,Truck/Lorry (Government),4,0,4,26.44999921,74.63998124
RAJASTHAN,2007,Truck/Lorry (Private),1477,241,1718,26.44999921,74.63998124
RAJASTHAN,2007,Bus (Government),62,17,79,26.44999921,74.63998124
RAJASTHAN,2007,Bus (Private),404,95,499,26.44999921,74.63998124
RAJASTHAN,2007,Tempo/Vans (Government),0,0,0,26.44999921,74.63998124
RAJASTHAN,2007,Tempo/Vans (Private),207,46,253,26.44999921,74.63998124
RAJASTHAN,2007,Jeep (Government),8,1,9,26.44999921,74.63998124
RAJASTHAN,2007,Jeep (Private),1059,255,1314,26.44999921,74.63998124
RAJASTHAN,2007,Car (Government),2,0,2,26.44999921,74.63998124
RAJASTHAN,2007,Car (Private),301,96,397,26.44999921,74.63998124
RAJASTHAN,2007,Three Wheeler,140,42,182,26.44999921,74.63998124
RAJASTHAN,2007,Two Wheeler,1224,192,1416,26.44999921,74.63998124
RAJASTHAN,2007,Bicycle,99,13,112,26.44999921,74.63998124
RAJASTHAN,2007,Pedestrian,603,142,745,26.44999921,74.63998124
RAJASTHAN,2007,Others (Please Specify),1184,231,1415,26.44999921,74.63998124
RAJASTHAN,2008,Truck/Lorry (Government),60,2,62,26.44999921,74.63998124
RAJASTHAN,2008,Truck/Lorry (Private),1421,148,1569,26.44999921,74.63998124
RAJASTHAN,2008,Bus (Government),50,15,65,26.44999921,74.63998124
RAJASTHAN,2008,Bus (Private),560,131,691,26.44999921,74.63998124
RAJASTHAN,2008,Tempo/Vans (Government),2,0,2,26.44999921,74.63998124
RAJASTHAN,2008,Tempo/Vans (Private),256,50,306,26.44999921,74.63998124
RAJASTHAN,2008,Jeep (Government),45,3,48,26.44999921,74.63998124
RAJASTHAN,2008,Jeep (Private),1020,203,1223,26.44999921,74.63998124
RAJASTHAN,2008,Car (Government),13,2,15,26.44999921,74.63998124
RAJASTHAN,2008,Car (Private),440,86,526,26.44999921,74.63998124
RAJASTHAN,2008,Three Wheeler,163,39,202,26.44999921,74.63998124
RAJASTHAN,2008,Two Wheeler,1455,198,1653,26.44999921,74.63998124
RAJASTHAN,2008,Bicycle,95,10,105,26.44999921,74.63998124
RAJASTHAN,2008,Pedestrian,546,141,687,26.44999921,74.63998124
RAJASTHAN,2008,Others (Please Specify),1068,166,1234,26.44999921,74.63998124
RAJASTHAN,2009,Truck/Lorry (Government),21,0,21,26.44999921,74.63998124
RAJASTHAN,2009,Truck/Lorry (Private),1632,188,1820,26.44999921,74.63998124
RAJASTHAN,2009,Bus (Government),80,24,104,26.44999921,74.63998124
RAJASTHAN,2009,Bus (Private),505,111,616,26.44999921,74.63998124
RAJASTHAN,2009,Tempo/Vans (Government),2,0,2,26.44999921,74.63998124
RAJASTHAN,2009,Tempo/Vans (Private),152,40,192,26.44999921,74.63998124
RAJASTHAN,2009,Jeep (Government),13,2,15,26.44999921,74.63998124
RAJASTHAN,2009,Jeep (Private),1138,237,1375,26.44999921,74.63998124
RAJASTHAN,2009,Car (Government),2,0,2,26.44999921,74.63998124
RAJASTHAN,2009,Car (Private),392,110,502,26.44999921,74.63998124
RAJASTHAN,2009,Three Wheeler,236,54,290,26.44999921,74.63998124
RAJASTHAN,2009,Two Wheeler,1505,169,1674,26.44999921,74.63998124
RAJASTHAN,2009,Bicycle,91,12,103,26.44999921,74.63998124
RAJASTHAN,2009,Pedestrian,478,137,615,26.44999921,74.63998124
RAJASTHAN,2009,Others (Please Specify),1476,238,1714,26.44999921,74.63998124
RAJASTHAN,2010,Truck/Lorry (Government),1,0,1,26.44999921,74.63998124
RAJASTHAN,2010,Truck/Lorry (Private),1525,110,1635,26.44999921,74.63998124
RAJASTHAN,2010,Bus (Government),75,15,90,26.44999921,74.63998124
RAJASTHAN,2010,Bus (Private),522,145,667,26.44999921,74.63998124
RAJASTHAN,2010,Tempo/Vans (Government),7,1,8,26.44999921,74.63998124
RAJASTHAN,2010,Tempo/Vans (Private),253,53,306,26.44999921,74.63998124
RAJASTHAN,2010,Jeep (Government),4,0,4,26.44999921,74.63998124
RAJASTHAN,2010,Jeep (Private),1096,212,1308,26.44999921,74.63998124
RAJASTHAN,2010,Car (Government),8,5,13,26.44999921,74.63998124
RAJASTHAN,2010,Car (Private),525,109,634,26.44999921,74.63998124
RAJASTHAN,2010,Three Wheeler,179,44,223,26.44999921,74.63998124
RAJASTHAN,2010,Two Wheeler,1795,198,1993,26.44999921,74.63998124
RAJASTHAN,2010,Bicycle,124,8,132,26.44999921,74.63998124
RAJASTHAN,2010,Pedestrian,715,177,892,26.44999921,74.63998124
RAJASTHAN,2010,Others (Please Specify),1116,141,1257,26.44999921,74.63998124
RAJASTHAN,2011,Truck/Lorry (Government),59,9,68,26.44999921,74.63998124
RAJASTHAN,2011,Truck/Lorry (Private),1457,91,1548,26.44999921,74.63998124
RAJASTHAN,2011,Bus (Government),61,14,75,26.44999921,74.63998124
RAJASTHAN,2011,Bus (Private),529,112,641,26.44999921,74.63998124
RAJASTHAN,2011,Tempo/Vans (Government),0,0,0,26.44999921,74.63998124
RAJASTHAN,2011,Tempo/Vans (Private),215,49,264,26.44999921,74.63998124
RAJASTHAN,2011,Jeep (Government),0,0,0,26.44999921,74.63998124
RAJASTHAN,2011,Jeep (Private),1184,227,1411,26.44999921,74.63998124
RAJASTHAN,2011,Car (Government),1,0,1,26.44999921,74.63998124
RAJASTHAN,2011,Car (Private),614,137,751,26.44999921,74.63998124
RAJASTHAN,2011,Three Wheeler,201,32,233,26.44999921,74.63998124
RAJASTHAN,2011,Two Wheeler,1731,266,1997,26.44999921,74.63998124
RAJASTHAN,2011,Bicycle,126,7,133,26.44999921,74.63998124
RAJASTHAN,2011,Pedestrian,752,174,926,26.44999921,74.63998124
RAJASTHAN,2011,Others (Please Specify),1048,136,1184,26.44999921,74.63998124
RAJASTHAN,2012,Truck/Lorry (Government),6,2,8,26.44999921,74.63998124
RAJASTHAN,2012,Truck/Lorry (Private),1391,117,1508,26.44999921,74.63998124
RAJASTHAN,2012,Bus (Government),118,28,146,26.44999921,74.63998124
RAJASTHAN,2012,Bus (Private),561,118,679,26.44999921,74.63998124
RAJASTHAN,2012,Tempo/Vans (Government),2,0,2,26.44999921,74.63998124
RAJASTHAN,2012,Tempo/Vans (Private),159,29,188,26.44999921,74.63998124
RAJASTHAN,2012,Jeep (Government),5,0,5,26.44999921,74.63998124
RAJASTHAN,2012,Jeep (Private),1137,209,1346,26.44999921,74.63998124
RAJASTHAN,2012,Car (Government),4,0,4,26.44999921,74.63998124
RAJASTHAN,2012,Car (Private),654,133,787,26.44999921,74.63998124
RAJASTHAN,2012,Three Wheeler,150,32,182,26.44999921,74.63998124
RAJASTHAN,2012,Two Wheeler,1918,278,2196,26.44999921,74.63998124
RAJASTHAN,2012,Bicycle,111,8,119,26.44999921,74.63998124
RAJASTHAN,2012,Pedestrian,871,211,1082,26.44999921,74.63998124
RAJASTHAN,2012,Others (Please Specify),1130,146,1276,26.44999921,74.63998124
SIKKIM,2001,Truck/Lorry (Government),3,0,3,27.3333303,88.6166475
SIKKIM,2001,Truck/Lorry (Private),4,0,4,27.3333303,88.6166475
SIKKIM,2001,Bus (Government),0,0,0,27.3333303,88.6166475
SIKKIM,2001,Bus (Private),0,0,0,27.3333303,88.6166475
SIKKIM,2001,Tempo/Vans (Government),0,0,0,27.3333303,88.6166475
SIKKIM,2001,Tempo/Vans (Private),1,0,1,27.3333303,88.6166475
SIKKIM,2001,Jeep (Government),5,0,5,27.3333303,88.6166475
SIKKIM,2001,Jeep (Private),19,9,28,27.3333303,88.6166475
SIKKIM,2001,Car (Government),0,0,0,27.3333303,88.6166475
SIKKIM,2001,Car (Private),3,0,3,27.3333303,88.6166475
SIKKIM,2001,Three Wheeler,0,0,0,27.3333303,88.6166475
SIKKIM,2001,Two Wheeler,1,0,1,27.3333303,88.6166475
SIKKIM,2001,Bicycle,0,0,0,27.3333303,88.6166475
SIKKIM,2001,Pedestrian,0,0,0,27.3333303,88.6166475
SIKKIM,2001,Others (Please Specify),0,0,0,27.3333303,88.6166475
SIKKIM,2002,Truck/Lorry (Government),1,5,6,27.3333303,88.6166475
SIKKIM,2002,Truck/Lorry (Private),1,0,1,27.3333303,88.6166475
SIKKIM,2002,Bus (Government),0,0,0,27.3333303,88.6166475
SIKKIM,2002,Bus (Private),0,0,0,27.3333303,88.6166475
SIKKIM,2002,Tempo/Vans (Government),0,0,0,27.3333303,88.6166475
SIKKIM,2002,Tempo/Vans (Private),3,0,3,27.3333303,88.6166475
SIKKIM,2002,Jeep (Government),14,0,14,27.3333303,88.6166475
SIKKIM,2002,Jeep (Private),10,10,20,27.3333303,88.6166475
SIKKIM,2002,Car (Government),0,0,0,27.3333303,88.6166475
SIKKIM,2002,Car (Private),0,0,0,27.3333303,88.6166475
SIKKIM,2002,Three Wheeler,0,0,0,27.3333303,88.6166475
SIKKIM,2002,Two Wheeler,2,0,2,27.3333303,88.6166475
SIKKIM,2002,Bicycle,0,0,0,27.3333303,88.6166475
SIKKIM,2002,Pedestrian,2,1,3,27.3333303,88.6166475
SIKKIM,2002,Others (Please Specify),2,4,6,27.3333303,88.6166475
SIKKIM,2003,Truck/Lorry (Government),0,0,0,27.3333303,88.6166475
SIKKIM,2003,Truck/Lorry (Private),3,2,5,27.3333303,88.6166475
SIKKIM,2003,Bus (Government),0,0,0,27.3333303,88.6166475
SIKKIM,2003,Bus (Private),0,0,0,27.3333303,88.6166475
SIKKIM,2003,Tempo/Vans (Government),0,0,0,27.3333303,88.6166475
SIKKIM,2003,Tempo/Vans (Private),0,0,0,27.3333303,88.6166475
SIKKIM,2003,Jeep (Government),0,0,0,27.3333303,88.6166475
SIKKIM,2003,Jeep (Private),21,8,29,27.3333303,88.6166475
SIKKIM,2003,Car (Government),0,0,0,27.3333303,88.6166475
SIKKIM,2003,Car (Private),2,0,2,27.3333303,88.6166475
SIKKIM,2003,Three Wheeler,0,0,0,27.3333303,88.6166475
SIKKIM,2003,Two Wheeler,2,0,2,27.3333303,88.6166475
SIKKIM,2003,Bicycle,0,0,0,27.3333303,88.6166475
SIKKIM,2003,Pedestrian,2,0,2,27.3333303,88.6166475
SIKKIM,2003,Others (Please Specify),0,0,0,27.3333303,88.6166475
SIKKIM,2004,Truck/Lorry (Government),0,0,0,27.3333303,88.6166475
SIKKIM,2004,Truck/Lorry (Private),3,0,3,27.3333303,88.6166475
SIKKIM,2004,Bus (Government),0,0,0,27.3333303,88.6166475
SIKKIM,2004,Bus (Private),0,0,0,27.3333303,88.6166475
SIKKIM,2004,Tempo/Vans (Government),0,0,0,27.3333303,88.6166475
SIKKIM,2004,Tempo/Vans (Private),1,1,2,27.3333303,88.6166475
SIKKIM,2004,Jeep (Government),0,0,0,27.3333303,88.6166475
SIKKIM,2004,Jeep (Private),31,12,43,27.3333303,88.6166475
SIKKIM,2004,Car (Government),0,0,0,27.3333303,88.6166475
SIKKIM,2004,Car (Private),0,0,0,27.3333303,88.6166475
SIKKIM,2004,Three Wheeler,0,0,0,27.3333303,88.6166475
SIKKIM,2004,Two Wheeler,3,0,3,27.3333303,88.6166475
SIKKIM,2004,Bicycle,0,0,0,27.3333303,88.6166475
SIKKIM,2004,Pedestrian,0,0,0,27.3333303,88.6166475
SIKKIM,2004,Others (Please Specify),0,0,0,27.3333303,88.6166475
SIKKIM,2005,Truck/Lorry (Government),0,0,0,27.3333303,88.6166475
SIKKIM,2005,Truck/Lorry (Private),17,2,19,27.3333303,88.6166475
SIKKIM,2005,Bus (Government),0,0,0,27.3333303,88.6166475
SIKKIM,2005,Bus (Private),0,0,0,27.3333303,88.6166475
SIKKIM,2005,Tempo/Vans (Government),0,0,0,27.3333303,88.6166475
SIKKIM,2005,Tempo/Vans (Private),2,0,2,27.3333303,88.6166475
SIKKIM,2005,Jeep (Government),0,0,0,27.3333303,88.6166475
SIKKIM,2005,Jeep (Private),43,7,50,27.3333303,88.6166475
SIKKIM,2005,Car (Government),0,0,0,27.3333303,88.6166475
SIKKIM,2005,Car (Private),0,2,2,27.3333303,88.6166475
SIKKIM,2005,Three Wheeler,0,0,0,27.3333303,88.6166475
SIKKIM,2005,Two Wheeler,1,0,1,27.3333303,88.6166475
SIKKIM,2005,Bicycle,0,0,0,27.3333303,88.6166475
SIKKIM,2005,Pedestrian,1,1,2,27.3333303,88.6166475
SIKKIM,2005,Others (Please Specify),1,0,1,27.3333303,88.6166475
SIKKIM,2006,Truck/Lorry (Government),0,0,0,27.3333303,88.6166475
SIKKIM,2006,Truck/Lorry (Private),20,2,22,27.3333303,88.6166475
SIKKIM,2006,Bus (Government),15,17,32,27.3333303,88.6166475
SIKKIM,2006,Bus (Private),0,0,0,27.3333303,88.6166475
SIKKIM,2006,Tempo/Vans (Government),0,0,0,27.3333303,88.6166475
SIKKIM,2006,Tempo/Vans (Private),0,0,0,27.3333303,88.6166475
SIKKIM,2006,Jeep (Government),0,0,0,27.3333303,88.6166475
SIKKIM,2006,Jeep (Private),19,9,28,27.3333303,88.6166475
SIKKIM,2006,Car (Government),0,0,0,27.3333303,88.6166475
SIKKIM,2006,Car (Private),5,1,6,27.3333303,88.6166475
SIKKIM,2006,Three Wheeler,0,0,0,27.3333303,88.6166475
SIKKIM,2006,Two Wheeler,0,0,0,27.3333303,88.6166475
SIKKIM,2006,Bicycle,0,0,0,27.3333303,88.6166475
SIKKIM,2006,Pedestrian,0,0,0,27.3333303,88.6166475
SIKKIM,2006,Others (Please Specify),0,0,0,27.3333303,88.6166475
SIKKIM,2007,Truck/Lorry (Government),0,0,0,27.3333303,88.6166475
SIKKIM,2007,Truck/Lorry (Private),9,1,10,27.3333303,88.6166475
SIKKIM,2007,Bus (Government),10,3,13,27.3333303,88.6166475
SIKKIM,2007,Bus (Private),0,0,0,27.3333303,88.6166475
SIKKIM,2007,Tempo/Vans (Government),0,0,0,27.3333303,88.6166475
SIKKIM,2007,Tempo/Vans (Private),0,0,0,27.3333303,88.6166475
SIKKIM,2007,Jeep (Government),0,0,0,27.3333303,88.6166475
SIKKIM,2007,Jeep (Private),10,4,14,27.3333303,88.6166475
SIKKIM,2007,Car (Government),0,0,0,27.3333303,88.6166475
SIKKIM,2007,Car (Private),3,3,6,27.3333303,88.6166475
SIKKIM,2007,Three Wheeler,0,0,0,27.3333303,88.6166475
SIKKIM,2007,Two Wheeler,2,0,2,27.3333303,88.6166475
SIKKIM,2007,Bicycle,0,0,0,27.3333303,88.6166475
SIKKIM,2007,Pedestrian,0,0,0,27.3333303,88.6166475
SIKKIM,2007,Others (Please Specify),6,1,7,27.3333303,88.6166475
SIKKIM,2008,Truck/Lorry (Government),0,0,0,27.3333303,88.6166475
SIKKIM,2008,Truck/Lorry (Private),10,0,10,27.3333303,88.6166475
SIKKIM,2008,Bus (Government),0,0,0,27.3333303,88.6166475
SIKKIM,2008,Bus (Private),0,0,0,27.3333303,88.6166475
SIKKIM,2008,Tempo/Vans (Government),0,0,0,27.3333303,88.6166475
SIKKIM,2008,Tempo/Vans (Private),0,0,0,27.3333303,88.6166475
SIKKIM,2008,Jeep (Government),0,0,0,27.3333303,88.6166475
SIKKIM,2008,Jeep (Private),0,0,0,27.3333303,88.6166475
SIKKIM,2008,Car (Government),0,0,0,27.3333303,88.6166475
SIKKIM,2008,Car (Private),0,0,0,27.3333303,88.6166475
SIKKIM,2008,Three Wheeler,0,0,0,27.3333303,88.6166475
SIKKIM,2008,Two Wheeler,1,0,1,27.3333303,88.6166475
SIKKIM,2008,Bicycle,0,0,0,27.3333303,88.6166475
SIKKIM,2008,Pedestrian,0,0,0,27.3333303,88.6166475
SIKKIM,2008,Others (Please Specify),56,12,68,27.3333303,88.6166475
SIKKIM,2009,Truck/Lorry (Government),0,0,0,27.3333303,88.6166475
SIKKIM,2009,Truck/Lorry (Private),1,0,1,27.3333303,88.6166475
SIKKIM,2009,Bus (Government),0,0,0,27.3333303,88.6166475
SIKKIM,2009,Bus (Private),0,0,0,27.3333303,88.6166475
SIKKIM,2009,Tempo/Vans (Government),0,0,0,27.3333303,88.6166475
SIKKIM,2009,Tempo/Vans (Private),0,0,0,27.3333303,88.6166475
SIKKIM,2009,Jeep (Government),0,0,0,27.3333303,88.6166475
SIKKIM,2009,Jeep (Private),42,40,82,27.3333303,88.6166475
SIKKIM,2009,Car (Government),0,0,0,27.3333303,88.6166475
SIKKIM,2009,Car (Private),2,0,2,27.3333303,88.6166475
SIKKIM,2009,Three Wheeler,0,0,0,27.3333303,88.6166475
SIKKIM,2009,Two Wheeler,0,0,0,27.3333303,88.6166475
SIKKIM,2009,Bicycle,0,0,0,27.3333303,88.6166475
SIKKIM,2009,Pedestrian,1,0,1,27.3333303,88.6166475
SIKKIM,2009,Others (Please Specify),1,0,1,27.3333303,88.6166475
SIKKIM,2010,Truck/Lorry (Government),0,0,0,27.3333303,88.6166475
SIKKIM,2010,Truck/Lorry (Private),0,0,0,27.3333303,88.6166475
SIKKIM,2010,Bus (Government),0,0,0,27.3333303,88.6166475
SIKKIM,2010,Bus (Private),0,0,0,27.3333303,88.6166475
SIKKIM,2010,Tempo/Vans (Government),0,0,0,27.3333303,88.6166475
SIKKIM,2010,Tempo/Vans (Private),0,0,0,27.3333303,88.6166475
SIKKIM,2010,Jeep (Government),0,0,0,27.3333303,88.6166475
SIKKIM,2010,Jeep (Private),52,14,66,27.3333303,88.6166475
SIKKIM,2010,Car (Government),0,0,0,27.3333303,88.6166475
SIKKIM,2010,Car (Private),3,2,5,27.3333303,88.6166475
SIKKIM,2010,Three Wheeler,0,0,0,27.3333303,88.6166475
SIKKIM,2010,Two Wheeler,0,0,0,27.3333303,88.6166475
SIKKIM,2010,Bicycle,0,0,0,27.3333303,88.6166475
SIKKIM,2010,Pedestrian,0,0,0,27.3333303,88.6166475
SIKKIM,2010,Others (Please Specify),0,0,0,27.3333303,88.6166475
SIKKIM,2011,Truck/Lorry (Government),0,0,0,27.3333303,88.6166475
SIKKIM,2011,Truck/Lorry (Private),2,2,4,27.3333303,88.6166475
SIKKIM,2011,Bus (Government),0,0,0,27.3333303,88.6166475
SIKKIM,2011,Bus (Private),0,0,0,27.3333303,88.6166475
SIKKIM,2011,Tempo/Vans (Government),0,0,0,27.3333303,88.6166475
SIKKIM,2011,Tempo/Vans (Private),0,0,0,27.3333303,88.6166475
SIKKIM,2011,Jeep (Government),0,0,0,27.3333303,88.6166475
SIKKIM,2011,Jeep (Private),82,15,97,27.3333303,88.6166475
SIKKIM,2011,Car (Government),0,0,0,27.3333303,88.6166475
SIKKIM,2011,Car (Private),3,2,5,27.3333303,88.6166475
SIKKIM,2011,Three Wheeler,0,0,0,27.3333303,88.6166475
SIKKIM,2011,Two Wheeler,0,0,0,27.3333303,88.6166475
SIKKIM,2011,Bicycle,0,0,0,27.3333303,88.6166475
SIKKIM,2011,Pedestrian,0,0,0,27.3333303,88.6166475
SIKKIM,2011,Others (Please Specify),0,0,0,27.3333303,88.6166475
SIKKIM,2012,Truck/Lorry (Government),0,0,0,27.3333303,88.6166475
SIKKIM,2012,Truck/Lorry (Private),10,3,13,27.3333303,88.6166475
SIKKIM,2012,Bus (Government),0,0,0,27.3333303,88.6166475
SIKKIM,2012,Bus (Private),0,0,0,27.3333303,88.6166475
SIKKIM,2012,Tempo/Vans (Government),0,0,0,27.3333303,88.6166475
SIKKIM,2012,Tempo/Vans (Private),2,0,2,27.3333303,88.6166475
SIKKIM,2012,Jeep (Government),3,1,4,27.3333303,88.6166475
SIKKIM,2012,Jeep (Private),19,2,21,27.3333303,88.6166475
SIKKIM,2012,Car (Government),0,0,0,27.3333303,88.6166475
SIKKIM,2012,Car (Private),2,0,2,27.3333303,88.6166475
SIKKIM,2012,Three Wheeler,0,0,0,27.3333303,88.6166475
SIKKIM,2012,Two Wheeler,1,0,1,27.3333303,88.6166475
SIKKIM,2012,Bicycle,0,1,1,27.3333303,88.6166475
SIKKIM,2012,Pedestrian,0,0,0,27.3333303,88.6166475
SIKKIM,2012,Others (Please Specify),0,0,0,27.3333303,88.6166475
TAMIL NADU,2001,Truck/Lorry (Government),5,2,7,12.92038576,79.15004187
TAMIL NADU,2001,Truck/Lorry (Private),2819,380,3199,12.92038576,79.15004187
TAMIL NADU,2001,Bus (Government),1251,235,1486,12.92038576,79.15004187
TAMIL NADU,2001,Bus (Private),603,156,759,12.92038576,79.15004187
TAMIL NADU,2001,Tempo/Vans (Government),29,5,34,12.92038576,79.15004187
TAMIL NADU,2001,Tempo/Vans (Private),839,230,1069,12.92038576,79.15004187
TAMIL NADU,2001,Jeep (Government),22,8,30,12.92038576,79.15004187
TAMIL NADU,2001,Jeep (Private),173,40,213,12.92038576,79.15004187
TAMIL NADU,2001,Car (Government),37,1,38,12.92038576,79.15004187
TAMIL NADU,2001,Car (Private),511,163,674,12.92038576,79.15004187
TAMIL NADU,2001,Three Wheeler,168,33,201,12.92038576,79.15004187
TAMIL NADU,2001,Two Wheeler,871,174,1045,12.92038576,79.15004187
TAMIL NADU,2001,Bicycle,81,31,112,12.92038576,79.15004187
TAMIL NADU,2001,Pedestrian,93,87,180,12.92038576,79.15004187
TAMIL NADU,2001,Others (Please Specify),372,152,524,12.92038576,79.15004187
TAMIL NADU,2002,Truck/Lorry (Government),33,9,42,12.92038576,79.15004187
TAMIL NADU,2002,Truck/Lorry (Private),2631,425,3056,12.92038576,79.15004187
TAMIL NADU,2002,Bus (Government),1229,205,1434,12.92038576,79.15004187
TAMIL NADU,2002,Bus (Private),708,192,900,12.92038576,79.15004187
TAMIL NADU,2002,Tempo/Vans (Government),6,6,12,12.92038576,79.15004187
TAMIL NADU,2002,Tempo/Vans (Private),807,190,997,12.92038576,79.15004187
TAMIL NADU,2002,Jeep (Government),14,3,17,12.92038576,79.15004187
TAMIL NADU,2002,Jeep (Private),130,29,159,12.92038576,79.15004187
TAMIL NADU,2002,Car (Government),25,12,37,12.92038576,79.15004187
TAMIL NADU,2002,Car (Private),755,171,926,12.92038576,79.15004187
TAMIL NADU,2002,Three Wheeler,215,38,253,12.92038576,79.15004187
TAMIL NADU,2002,Two Wheeler,1110,74,1184,12.92038576,79.15004187
TAMIL NADU,2002,Bicycle,167,16,183,12.92038576,79.15004187
TAMIL NADU,2002,Pedestrian,335,92,427,12.92038576,79.15004187
TAMIL NADU,2002,Others (Please Specify),266,46,312,12.92038576,79.15004187
TAMIL NADU,2003,Truck/Lorry (Government),11,1,12,12.92038576,79.15004187
TAMIL NADU,2003,Truck/Lorry (Private),2444,416,2860,12.92038576,79.15004187
TAMIL NADU,2003,Bus (Government),1007,250,1257,12.92038576,79.15004187
TAMIL NADU,2003,Bus (Private),623,167,790,12.92038576,79.15004187
TAMIL NADU,2003,Tempo/Vans (Government),14,3,17,12.92038576,79.15004187
TAMIL NADU,2003,Tempo/Vans (Private),719,171,890,12.92038576,79.15004187
TAMIL NADU,2003,Jeep (Government),5,2,7,12.92038576,79.15004187
TAMIL NADU,2003,Jeep (Private),136,26,162,12.92038576,79.15004187
TAMIL NADU,2003,Car (Government),5,1,6,12.92038576,79.15004187
TAMIL NADU,2003,Car (Private),769,181,950,12.92038576,79.15004187
TAMIL NADU,2003,Three Wheeler,274,43,317,12.92038576,79.15004187
TAMIL NADU,2003,Two Wheeler,1046,172,1218,12.92038576,79.15004187
TAMIL NADU,2003,Bicycle,78,16,94,12.92038576,79.15004187
TAMIL NADU,2003,Pedestrian,409,75,484,12.92038576,79.15004187
TAMIL NADU,2003,Others (Please Specify),152,59,211,12.92038576,79.15004187
TAMIL NADU,2004,Truck/Lorry (Government),5,2,7,12.92038576,79.15004187
TAMIL NADU,2004,Truck/Lorry (Private),2424,297,2721,12.92038576,79.15004187
TAMIL NADU,2004,Bus (Government),1007,191,1198,12.92038576,79.15004187
TAMIL NADU,2004,Bus (Private),607,128,735,12.92038576,79.15004187
TAMIL NADU,2004,Tempo/Vans (Government),9,1,10,12.92038576,79.15004187
TAMIL NADU,2004,Tempo/Vans (Private),759,210,969,12.92038576,79.15004187
TAMIL NADU,2004,Jeep (Government),10,0,10,12.92038576,79.15004187
TAMIL NADU,2004,Jeep (Private),85,17,102,12.92038576,79.15004187
TAMIL NADU,2004,Car (Government),14,7,21,12.92038576,79.15004187
TAMIL NADU,2004,Car (Private),867,172,1039,12.92038576,79.15004187
TAMIL NADU,2004,Three Wheeler,303,57,360,12.92038576,79.15004187
TAMIL NADU,2004,Two Wheeler,1213,211,1424,12.92038576,79.15004187
TAMIL NADU,2004,Bicycle,148,15,163,12.92038576,79.15004187
TAMIL NADU,2004,Pedestrian,262,104,366,12.92038576,79.15004187
TAMIL NADU,2004,Others (Please Specify),318,64,382,12.92038576,79.15004187
TAMIL NADU,2005,Truck/Lorry (Government),2,2,4,12.92038576,79.15004187
TAMIL NADU,2005,Truck/Lorry (Private),2823,292,3115,12.92038576,79.15004187
TAMIL NADU,2005,Bus (Government),1483,299,1782,12.92038576,79.15004187
TAMIL NADU,2005,Bus (Private),948,278,1226,12.92038576,79.15004187
TAMIL NADU,2005,Tempo/Vans (Government),31,22,53,12.92038576,79.15004187
TAMIL NADU,2005,Tempo/Vans (Private),1287,214,1501,12.92038576,79.15004187
TAMIL NADU,2005,Jeep (Government),22,4,26,12.92038576,79.15004187
TAMIL NADU,2005,Jeep (Private),68,7,75,12.92038576,79.15004187
TAMIL NADU,2005,Car (Government),7,4,11,12.92038576,79.15004187
TAMIL NADU,2005,Car (Private),1389,275,1664,12.92038576,79.15004187
TAMIL NADU,2005,Three Wheeler,476,70,546,12.92038576,79.15004187
TAMIL NADU,2005,Two Wheeler,1945,383,2328,12.92038576,79.15004187
TAMIL NADU,2005,Bicycle,334,12,346,12.92038576,79.15004187
TAMIL NADU,2005,Pedestrian,735,174,909,12.92038576,79.15004187
TAMIL NADU,2005,Others (Please Specify),317,58,375,12.92038576,79.15004187
TAMIL NADU,2006,Truck/Lorry (Government),29,5,34,12.92038576,79.15004187
TAMIL NADU,2006,Truck/Lorry (Private),2387,183,2570,12.92038576,79.15004187
TAMIL NADU,2006,Bus (Government),1158,252,1410,12.92038576,79.15004187
TAMIL NADU,2006,Bus (Private),851,77,928,12.92038576,79.15004187
TAMIL NADU,2006,Tempo/Vans (Government),21,0,21,12.92038576,79.15004187
TAMIL NADU,2006,Tempo/Vans (Private),160,145,305,12.92038576,79.15004187
TAMIL NADU,2006,Jeep (Government),4,0,4,12.92038576,79.15004187
TAMIL NADU,2006,Jeep (Private),162,12,174,12.92038576,79.15004187
TAMIL NADU,2006,Car (Government),11,1,12,12.92038576,79.15004187
TAMIL NADU,2006,Car (Private),1859,239,2098,12.92038576,79.15004187
TAMIL NADU,2006,Three Wheeler,457,97,554,12.92038576,79.15004187
TAMIL NADU,2006,Two Wheeler,1909,263,2172,12.92038576,79.15004187
TAMIL NADU,2006,Bicycle,326,22,348,12.92038576,79.15004187
TAMIL NADU,2006,Pedestrian,290,89,379,12.92038576,79.15004187
TAMIL NADU,2006,Others (Please Specify),0,0,0,12.92038576,79.15004187
TAMIL NADU,2007,Truck/Lorry (Government),30,8,38,12.92038576,79.15004187
TAMIL NADU,2007,Truck/Lorry (Private),2480,276,2756,12.92038576,79.15004187
TAMIL NADU,2007,Bus (Government),807,255,1062,12.92038576,79.15004187
TAMIL NADU,2007,Bus (Private),1326,173,1499,12.92038576,79.15004187
TAMIL NADU,2007,Tempo/Vans (Government),22,0,22,12.92038576,79.15004187
TAMIL NADU,2007,Tempo/Vans (Private),167,219,386,12.92038576,79.15004187
TAMIL NADU,2007,Jeep (Government),4,0,4,12.92038576,79.15004187
TAMIL NADU,2007,Jeep (Private),168,18,186,12.92038576,79.15004187
TAMIL NADU,2007,Car (Government),11,2,13,12.92038576,79.15004187
TAMIL NADU,2007,Car (Private),1994,269,2263,12.92038576,79.15004187
TAMIL NADU,2007,Three Wheeler,475,146,621,12.92038576,79.15004187
TAMIL NADU,2007,Two Wheeler,1982,398,2380,12.92038576,79.15004187
TAMIL NADU,2007,Bicycle,340,32,372,12.92038576,79.15004187
TAMIL NADU,2007,Pedestrian,304,130,434,12.92038576,79.15004187
TAMIL NADU,2007,Others (Please Specify),0,0,0,12.92038576,79.15004187
TAMIL NADU,2008,Truck/Lorry (Government),24,8,32,12.92038576,79.15004187
TAMIL NADU,2008,Truck/Lorry (Private),2596,297,2893,12.92038576,79.15004187
TAMIL NADU,2008,Bus (Government),1027,507,1534,12.92038576,79.15004187
TAMIL NADU,2008,Bus (Private),779,163,942,12.92038576,79.15004187
TAMIL NADU,2008,Tempo/Vans (Government),22,0,22,12.92038576,79.15004187
TAMIL NADU,2008,Tempo/Vans (Private),195,217,412,12.92038576,79.15004187
TAMIL NADU,2008,Jeep (Government),17,0,17,12.92038576,79.15004187
TAMIL NADU,2008,Jeep (Private),185,27,212,12.92038576,79.15004187
TAMIL NADU,2008,Car (Government),13,4,17,12.92038576,79.15004187
TAMIL NADU,2008,Car (Private),1764,273,2037,12.92038576,79.15004187
TAMIL NADU,2008,Three Wheeler,415,123,538,12.92038576,79.15004187
TAMIL NADU,2008,Two Wheeler,2045,610,2655,12.92038576,79.15004187
TAMIL NADU,2008,Bicycle,496,315,811,12.92038576,79.15004187
TAMIL NADU,2008,Pedestrian,426,236,662,12.92038576,79.15004187
TAMIL NADU,2008,Others (Please Specify),0,0,0,12.92038576,79.15004187
TAMIL NADU,2009,Truck/Lorry (Government),120,14,134,12.92038576,79.15004187
TAMIL NADU,2009,Truck/Lorry (Private),2557,351,2908,12.92038576,79.15004187
TAMIL NADU,2009,Bus (Government),1223,316,1539,12.92038576,79.15004187
TAMIL NADU,2009,Bus (Private),786,201,987,12.92038576,79.15004187
TAMIL NADU,2009,Tempo/Vans (Government),18,2,20,12.92038576,79.15004187
TAMIL NADU,2009,Tempo/Vans (Private),649,113,762,12.92038576,79.15004187
TAMIL NADU,2009,Jeep (Government),23,3,26,12.92038576,79.15004187
TAMIL NADU,2009,Jeep (Private),164,19,183,12.92038576,79.15004187
TAMIL NADU,2009,Car (Government),178,16,194,12.92038576,79.15004187
TAMIL NADU,2009,Car (Private),2228,344,2572,12.92038576,79.15004187
TAMIL NADU,2009,Three Wheeler,391,107,498,12.92038576,79.15004187
TAMIL NADU,2009,Two Wheeler,2917,334,3251,12.92038576,79.15004187
TAMIL NADU,2009,Bicycle,307,44,351,12.92038576,79.15004187
TAMIL NADU,2009,Pedestrian,130,48,178,12.92038576,79.15004187
TAMIL NADU,2009,Others (Please Specify),91,52,143,12.92038576,79.15004187
TAMIL NADU,2010,Truck/Lorry (Government),41,21,62,12.92038576,79.15004187
TAMIL NADU,2010,Truck/Lorry (Private),2546,497,3043,12.92038576,79.15004187
TAMIL NADU,2010,Bus (Government),1171,379,1550,12.92038576,79.15004187
TAMIL NADU,2010,Bus (Private),845,158,1003,12.92038576,79.15004187
TAMIL NADU,2010,Tempo/Vans (Government),17,2,19,12.92038576,79.15004187
TAMIL NADU,2010,Tempo/Vans (Private),1205,272,1477,12.92038576,79.15004187
TAMIL NADU,2010,Jeep (Government),10,0,10,12.92038576,79.15004187
TAMIL NADU,2010,Jeep (Private),166,21,187,12.92038576,79.15004187
TAMIL NADU,2010,Car (Government),48,8,56,12.92038576,79.15004187
TAMIL NADU,2010,Car (Private),1608,294,1902,12.92038576,79.15004187
TAMIL NADU,2010,Three Wheeler,388,86,474,12.92038576,79.15004187
TAMIL NADU,2010,Two Wheeler,3428,407,3835,12.92038576,79.15004187
TAMIL NADU,2010,Bicycle,273,14,287,12.92038576,79.15004187
TAMIL NADU,2010,Pedestrian,842,251,1093,12.92038576,79.15004187
TAMIL NADU,2010,Others (Please Specify),367,44,411,12.92038576,79.15004187
TAMIL NADU,2011,Truck/Lorry (Government),12,4,16,12.92038576,79.15004187
TAMIL NADU,2011,Truck/Lorry (Private),2656,436,3092,12.92038576,79.15004187
TAMIL NADU,2011,Bus (Government),1144,173,1317,12.92038576,79.15004187
TAMIL NADU,2011,Bus (Private),817,182,999,12.92038576,79.15004187
TAMIL NADU,2011,Tempo/Vans (Government),1,4,5,12.92038576,79.15004187
TAMIL NADU,2011,Tempo/Vans (Private),985,234,1219,12.92038576,79.15004187
TAMIL NADU,2011,Jeep (Government),7,0,7,12.92038576,79.15004187
TAMIL NADU,2011,Jeep (Private),219,54,273,12.92038576,79.15004187
TAMIL NADU,2011,Car (Government),139,24,163,12.92038576,79.15004187
TAMIL NADU,2011,Car (Private),1677,273,1950,12.92038576,79.15004187
TAMIL NADU,2011,Three Wheeler,347,84,431,12.92038576,79.15004187
TAMIL NADU,2011,Two Wheeler,3488,374,3862,12.92038576,79.15004187
TAMIL NADU,2011,Bicycle,322,19,341,12.92038576,79.15004187
TAMIL NADU,2011,Pedestrian,833,215,1048,12.92038576,79.15004187
TAMIL NADU,2011,Others (Please Specify),508,191,699,12.92038576,79.15004187
TAMIL NADU,2012,Truck/Lorry (Government),8,6,14,12.92038576,79.15004187
TAMIL NADU,2012,Truck/Lorry (Private),2617,396,3013,12.92038576,79.15004187
TAMIL NADU,2012,Bus (Government),1131,149,1280,12.92038576,79.15004187
TAMIL NADU,2012,Bus (Private),681,235,916,12.92038576,79.15004187
TAMIL NADU,2012,Tempo/Vans (Government),7,1,8,12.92038576,79.15004187
TAMIL NADU,2012,Tempo/Vans (Private),861,186,1047,12.92038576,79.15004187
TAMIL NADU,2012,Jeep (Government),3,16,19,12.92038576,79.15004187
TAMIL NADU,2012,Jeep (Private),245,60,305,12.92038576,79.15004187
TAMIL NADU,2012,Car (Government),103,34,137,12.92038576,79.15004187
TAMIL NADU,2012,Car (Private),2148,246,2394,12.92038576,79.15004187
TAMIL NADU,2012,Three Wheeler,318,72,390,12.92038576,79.15004187
TAMIL NADU,2012,Two Wheeler,3997,469,4466,12.92038576,79.15004187
TAMIL NADU,2012,Bicycle,532,27,559,12.92038576,79.15004187
TAMIL NADU,2012,Pedestrian,196,538,734,12.92038576,79.15004187
TAMIL NADU,2012,Others (Please Specify),650,243,893,12.92038576,79.15004187
TRIPURA,2001,Truck/Lorry (Government),0,0,0,23.83540428,91.27999914
TRIPURA,2001,Truck/Lorry (Private),34,6,40,23.83540428,91.27999914
TRIPURA,2001,Bus (Government),0,0,0,23.83540428,91.27999914
TRIPURA,2001,Bus (Private),16,4,20,23.83540428,91.27999914
TRIPURA,2001,Tempo/Vans (Government),0,0,0,23.83540428,91.27999914
TRIPURA,2001,Tempo/Vans (Private),2,1,3,23.83540428,91.27999914
TRIPURA,2001,Jeep (Government),0,0,0,23.83540428,91.27999914
TRIPURA,2001,Jeep (Private),85,12,97,23.83540428,91.27999914
TRIPURA,2001,Car (Government),0,0,0,23.83540428,91.27999914
TRIPURA,2001,Car (Private),0,0,0,23.83540428,91.27999914
TRIPURA,2001,Three Wheeler,10,1,11,23.83540428,91.27999914
TRIPURA,2001,Two Wheeler,4,0,4,23.83540428,91.27999914
TRIPURA,2001,Bicycle,0,0,0,23.83540428,91.27999914
TRIPURA,2001,Pedestrian,0,0,0,23.83540428,91.27999914
TRIPURA,2001,Others (Please Specify),0,0,0,23.83540428,91.27999914
TRIPURA,2002,Truck/Lorry (Government),1,0,1,23.83540428,91.27999914
TRIPURA,2002,Truck/Lorry (Private),29,3,32,23.83540428,91.27999914
TRIPURA,2002,Bus (Government),2,1,3,23.83540428,91.27999914
TRIPURA,2002,Bus (Private),16,2,18,23.83540428,91.27999914
TRIPURA,2002,Tempo/Vans (Government),0,0,0,23.83540428,91.27999914
TRIPURA,2002,Tempo/Vans (Private),4,1,5,23.83540428,91.27999914
TRIPURA,2002,Jeep (Government),1,0,1,23.83540428,91.27999914
TRIPURA,2002,Jeep (Private),19,29,48,23.83540428,91.27999914
TRIPURA,2002,Car (Government),1,1,2,23.83540428,91.27999914
TRIPURA,2002,Car (Private),2,0,2,23.83540428,91.27999914
TRIPURA,2002,Three Wheeler,5,1,6,23.83540428,91.27999914
TRIPURA,2002,Two Wheeler,5,2,7,23.83540428,91.27999914
TRIPURA,2002,Bicycle,4,0,4,23.83540428,91.27999914
TRIPURA,2002,Pedestrian,16,2,18,23.83540428,91.27999914
TRIPURA,2002,Others (Please Specify),6,4,10,23.83540428,91.27999914
TRIPURA,2003,Truck/Lorry (Government),0,0,0,23.83540428,91.27999914
TRIPURA,2003,Truck/Lorry (Private),19,6,25,23.83540428,91.27999914
TRIPURA,2003,Bus (Government),0,0,0,23.83540428,91.27999914
TRIPURA,2003,Bus (Private),15,5,20,23.83540428,91.27999914
TRIPURA,2003,Tempo/Vans (Government),0,0,0,23.83540428,91.27999914
TRIPURA,2003,Tempo/Vans (Private),0,0,0,23.83540428,91.27999914
TRIPURA,2003,Jeep (Government),0,0,0,23.83540428,91.27999914
TRIPURA,2003,Jeep (Private),20,5,25,23.83540428,91.27999914
TRIPURA,2003,Car (Government),0,0,0,23.83540428,91.27999914
TRIPURA,2003,Car (Private),20,5,25,23.83540428,91.27999914
TRIPURA,2003,Three Wheeler,0,0,0,23.83540428,91.27999914
TRIPURA,2003,Two Wheeler,26,2,28,23.83540428,91.27999914
TRIPURA,2003,Bicycle,0,0,0,23.83540428,91.27999914
TRIPURA,2003,Pedestrian,0,0,0,23.83540428,91.27999914
TRIPURA,2003,Others (Please Specify),29,16,45,23.83540428,91.27999914
TRIPURA,2004,Truck/Lorry (Government),0,0,0,23.83540428,91.27999914
TRIPURA,2004,Truck/Lorry (Private),21,7,28,23.83540428,91.27999914
TRIPURA,2004,Bus (Government),0,0,0,23.83540428,91.27999914
TRIPURA,2004,Bus (Private),13,5,18,23.83540428,91.27999914
TRIPURA,2004,Tempo/Vans (Government),0,0,0,23.83540428,91.27999914
TRIPURA,2004,Tempo/Vans (Private),15,3,18,23.83540428,91.27999914
TRIPURA,2004,Jeep (Government),1,2,3,23.83540428,91.27999914
TRIPURA,2004,Jeep (Private),46,14,60,23.83540428,91.27999914
TRIPURA,2004,Car (Government),0,0,0,23.83540428,91.27999914
TRIPURA,2004,Car (Private),6,3,9,23.83540428,91.27999914
TRIPURA,2004,Three Wheeler,3,0,3,23.83540428,91.27999914
TRIPURA,2004,Two Wheeler,2,0,2,23.83540428,91.27999914
TRIPURA,2004,Bicycle,1,0,1,23.83540428,91.27999914
TRIPURA,2004,Pedestrian,0,0,0,23.83540428,91.27999914
TRIPURA,2004,Others (Please Specify),16,21,37,23.83540428,91.27999914
TRIPURA,2005,Truck/Lorry (Government),1,0,1,23.83540428,91.27999914
TRIPURA,2005,Truck/Lorry (Private),36,4,40,23.83540428,91.27999914
TRIPURA,2005,Bus (Government),2,1,3,23.83540428,91.27999914
TRIPURA,2005,Bus (Private),14,4,18,23.83540428,91.27999914
TRIPURA,2005,Tempo/Vans (Government),0,0,0,23.83540428,91.27999914
TRIPURA,2005,Tempo/Vans (Private),9,3,12,23.83540428,91.27999914
TRIPURA,2005,Jeep (Government),2,1,3,23.83540428,91.27999914
TRIPURA,2005,Jeep (Private),39,6,45,23.83540428,91.27999914
TRIPURA,2005,Car (Government),0,0,0,23.83540428,91.27999914
TRIPURA,2005,Car (Private),5,4,9,23.83540428,91.27999914
TRIPURA,2005,Three Wheeler,12,1,13,23.83540428,91.27999914
TRIPURA,2005,Two Wheeler,7,2,9,23.83540428,91.27999914
TRIPURA,2005,Bicycle,1,1,2,23.83540428,91.27999914
TRIPURA,2005,Pedestrian,0,0,0,23.83540428,91.27999914
TRIPURA,2005,Others (Please Specify),30,19,49,23.83540428,91.27999914
TRIPURA,2006,Truck/Lorry (Government),0,0,0,23.83540428,91.27999914
TRIPURA,2006,Truck/Lorry (Private),26,1,27,23.83540428,91.27999914
TRIPURA,2006,Bus (Government),0,0,0,23.83540428,91.27999914
TRIPURA,2006,Bus (Private),2,0,2,23.83540428,91.27999914
TRIPURA,2006,Tempo/Vans (Government),0,0,0,23.83540428,91.27999914
TRIPURA,2006,Tempo/Vans (Private),0,0,0,23.83540428,91.27999914
TRIPURA,2006,Jeep (Government),0,0,0,23.83540428,91.27999914
TRIPURA,2006,Jeep (Private),56,18,74,23.83540428,91.27999914
TRIPURA,2006,Car (Government),0,0,0,23.83540428,91.27999914
TRIPURA,2006,Car (Private),4,1,5,23.83540428,91.27999914
TRIPURA,2006,Three Wheeler,32,16,48,23.83540428,91.27999914
TRIPURA,2006,Two Wheeler,7,3,10,23.83540428,91.27999914
TRIPURA,2006,Bicycle,1,0,1,23.83540428,91.27999914
TRIPURA,2006,Pedestrian,5,2,7,23.83540428,91.27999914
TRIPURA,2006,Others (Please Specify),17,5,22,23.83540428,91.27999914
TRIPURA,2007,Truck/Lorry (Government),4,0,4,23.83540428,91.27999914
TRIPURA,2007,Truck/Lorry (Private),37,2,39,23.83540428,91.27999914
TRIPURA,2007,Bus (Government),0,0,0,23.83540428,91.27999914
TRIPURA,2007,Bus (Private),22,8,30,23.83540428,91.27999914
TRIPURA,2007,Tempo/Vans (Government),0,0,0,23.83540428,91.27999914
TRIPURA,2007,Tempo/Vans (Private),3,0,3,23.83540428,91.27999914
TRIPURA,2007,Jeep (Government),2,0,2,23.83540428,91.27999914
TRIPURA,2007,Jeep (Private),36,14,50,23.83540428,91.27999914
TRIPURA,2007,Car (Government),0,1,1,23.83540428,91.27999914
TRIPURA,2007,Car (Private),19,2,21,23.83540428,91.27999914
TRIPURA,2007,Three Wheeler,19,1,20,23.83540428,91.27999914
TRIPURA,2007,Two Wheeler,19,1,20,23.83540428,91.27999914
TRIPURA,2007,Bicycle,0,0,0,23.83540428,91.27999914
TRIPURA,2007,Pedestrian,11,3,14,23.83540428,91.27999914
TRIPURA,2007,Others (Please Specify),19,0,19,23.83540428,91.27999914
TRIPURA,2008,Truck/Lorry (Government),0,0,0,23.83540428,91.27999914
TRIPURA,2008,Truck/Lorry (Private),54,7,61,23.83540428,91.27999914
TRIPURA,2008,Bus (Government),0,0,0,23.83540428,91.27999914
TRIPURA,2008,Bus (Private),9,1,10,23.83540428,91.27999914
TRIPURA,2008,Tempo/Vans (Government),0,0,0,23.83540428,91.27999914
TRIPURA,2008,Tempo/Vans (Private),5,1,6,23.83540428,91.27999914
TRIPURA,2008,Jeep (Government),0,0,0,23.83540428,91.27999914
TRIPURA,2008,Jeep (Private),45,8,53,23.83540428,91.27999914
TRIPURA,2008,Car (Government),0,0,0,23.83540428,91.27999914
TRIPURA,2008,Car (Private),5,1,6,23.83540428,91.27999914
TRIPURA,2008,Three Wheeler,20,3,23,23.83540428,91.27999914
TRIPURA,2008,Two Wheeler,21,4,25,23.83540428,91.27999914
TRIPURA,2008,Bicycle,0,0,0,23.83540428,91.27999914
TRIPURA,2008,Pedestrian,10,0,10,23.83540428,91.27999914
TRIPURA,2008,Others (Please Specify),22,5,27,23.83540428,91.27999914
TRIPURA,2009,Truck/Lorry (Government),0,0,0,23.83540428,91.27999914
TRIPURA,2009,Truck/Lorry (Private),27,5,32,23.83540428,91.27999914
TRIPURA,2009,Bus (Government),1,1,2,23.83540428,91.27999914
TRIPURA,2009,Bus (Private),9,3,12,23.83540428,91.27999914
TRIPURA,2009,Tempo/Vans (Government),0,0,0,23.83540428,91.27999914
TRIPURA,2009,Tempo/Vans (Private),14,4,18,23.83540428,91.27999914
TRIPURA,2009,Jeep (Government),0,0,0,23.83540428,91.27999914
TRIPURA,2009,Jeep (Private),19,9,28,23.83540428,91.27999914
TRIPURA,2009,Car (Government),1,0,1,23.83540428,91.27999914
TRIPURA,2009,Car (Private),15,3,18,23.83540428,91.27999914
TRIPURA,2009,Three Wheeler,15,3,18,23.83540428,91.27999914
TRIPURA,2009,Two Wheeler,29,3,32,23.83540428,91.27999914
TRIPURA,2009,Bicycle,8,0,8,23.83540428,91.27999914
TRIPURA,2009,Pedestrian,39,20,59,23.83540428,91.27999914
TRIPURA,2009,Others (Please Specify),0,1,1,23.83540428,91.27999914
TRIPURA,2010,Truck/Lorry (Government),0,0,0,23.83540428,91.27999914
TRIPURA,2010,Truck/Lorry (Private),44,4,48,23.83540428,91.27999914
TRIPURA,2010,Bus (Government),0,0,0,23.83540428,91.27999914
TRIPURA,2010,Bus (Private),15,2,17,23.83540428,91.27999914
TRIPURA,2010,Tempo/Vans (Government),0,0,0,23.83540428,91.27999914
TRIPURA,2010,Tempo/Vans (Private),21,5,26,23.83540428,91.27999914
TRIPURA,2010,Jeep (Government),0,0,0,23.83540428,91.27999914
TRIPURA,2010,Jeep (Private),45,10,55,23.83540428,91.27999914
TRIPURA,2010,Car (Government),0,0,0,23.83540428,91.27999914
TRIPURA,2010,Car (Private),9,2,11,23.83540428,91.27999914
TRIPURA,2010,Three Wheeler,7,0,7,23.83540428,91.27999914
TRIPURA,2010,Two Wheeler,38,5,43,23.83540428,91.27999914
TRIPURA,2010,Bicycle,9,0,9,23.83540428,91.27999914
TRIPURA,2010,Pedestrian,7,3,10,23.83540428,91.27999914
TRIPURA,2010,Others (Please Specify),10,0,10,23.83540428,91.27999914
TRIPURA,2011,Truck/Lorry (Government),1,0,1,23.83540428,91.27999914
TRIPURA,2011,Truck/Lorry (Private),47,1,48,23.83540428,91.27999914
TRIPURA,2011,Bus (Government),0,0,0,23.83540428,91.27999914
TRIPURA,2011,Bus (Private),20,3,23,23.83540428,91.27999914
TRIPURA,2011,Tempo/Vans (Government),0,0,0,23.83540428,91.27999914
TRIPURA,2011,Tempo/Vans (Private),17,6,23,23.83540428,91.27999914
TRIPURA,2011,Jeep (Government),5,0,5,23.83540428,91.27999914
TRIPURA,2011,Jeep (Private),26,14,40,23.83540428,91.27999914
TRIPURA,2011,Car (Government),0,0,0,23.83540428,91.27999914
TRIPURA,2011,Car (Private),15,0,15,23.83540428,91.27999914
TRIPURA,2011,Three Wheeler,14,2,16,23.83540428,91.27999914
TRIPURA,2011,Two Wheeler,38,9,47,23.83540428,91.27999914
TRIPURA,2011,Bicycle,6,0,6,23.83540428,91.27999914
TRIPURA,2011,Pedestrian,9,4,13,23.83540428,91.27999914
TRIPURA,2011,Others (Please Specify),7,1,8,23.83540428,91.27999914
TRIPURA,2012,Truck/Lorry (Government),0,0,0,23.83540428,91.27999914
TRIPURA,2012,Truck/Lorry (Private),0,0,0,23.83540428,91.27999914
TRIPURA,2012,Bus (Government),8,0,8,23.83540428,91.27999914
TRIPURA,2012,Bus (Private),6,3,9,23.83540428,91.27999914
TRIPURA,2012,Tempo/Vans (Government),0,0,0,23.83540428,91.27999914
TRIPURA,2012,Tempo/Vans (Private),6,3,9,23.83540428,91.27999914
TRIPURA,2012,Jeep (Government),1,0,1,23.83540428,91.27999914
TRIPURA,2012,Jeep (Private),39,10,49,23.83540428,91.27999914
TRIPURA,2012,Car (Government),1,0,1,23.83540428,91.27999914
TRIPURA,2012,Car (Private),10,4,14,23.83540428,91.27999914
TRIPURA,2012,Three Wheeler,18,3,21,23.83540428,91.27999914
TRIPURA,2012,Two Wheeler,38,8,46,23.83540428,91.27999914
TRIPURA,2012,Bicycle,2,1,3,23.83540428,91.27999914
TRIPURA,2012,Pedestrian,22,3,25,23.83540428,91.27999914
TRIPURA,2012,Others (Please Specify),79,7,86,23.83540428,91.27999914
UTTAR PRADESH,2001,Truck/Lorry (Government),100,33,133,27.59998069,78.05000565
UTTAR PRADESH,2001,Truck/Lorry (Private),1792,215,2007,27.59998069,78.05000565
UTTAR PRADESH,2001,Bus (Government),400,67,467,27.59998069,78.05000565
UTTAR PRADESH,2001,Bus (Private),696,99,795,27.59998069,78.05000565
UTTAR PRADESH,2001,Tempo/Vans (Government),9,4,13,27.59998069,78.05000565
UTTAR PRADESH,2001,Tempo/Vans (Private),635,111,746,27.59998069,78.05000565
UTTAR PRADESH,2001,Jeep (Government),21,5,26,27.59998069,78.05000565
UTTAR PRADESH,2001,Jeep (Private),1283,139,1422,27.59998069,78.05000565
UTTAR PRADESH,2001,Car (Government),35,13,48,27.59998069,78.05000565
UTTAR PRADESH,2001,Car (Private),531,113,644,27.59998069,78.05000565
UTTAR PRADESH,2001,Three Wheeler,362,77,439,27.59998069,78.05000565
UTTAR PRADESH,2001,Two Wheeler,683,80,763,27.59998069,78.05000565
UTTAR PRADESH,2001,Bicycle,379,24,403,27.59998069,78.05000565
UTTAR PRADESH,2001,Pedestrian,718,242,960,27.59998069,78.05000565
UTTAR PRADESH,2001,Others (Please Specify),284,46,330,27.59998069,78.05000565
UTTAR PRADESH,2002,Truck/Lorry (Government),158,63,221,27.59998069,78.05000565
UTTAR PRADESH,2002,Truck/Lorry (Private),2040,164,2204,27.59998069,78.05000565
UTTAR PRADESH,2002,Bus (Government),208,25,233,27.59998069,78.05000565
UTTAR PRADESH,2002,Bus (Private),778,136,914,27.59998069,78.05000565
UTTAR PRADESH,2002,Tempo/Vans (Government),47,3,50,27.59998069,78.05000565
UTTAR PRADESH,2002,Tempo/Vans (Private),636,100,736,27.59998069,78.05000565
UTTAR PRADESH,2002,Jeep (Government),56,9,65,27.59998069,78.05000565
UTTAR PRADESH,2002,Jeep (Private),1166,194,1360,27.59998069,78.05000565
UTTAR PRADESH,2002,Car (Government),27,6,33,27.59998069,78.05000565
UTTAR PRADESH,2002,Car (Private),550,114,664,27.59998069,78.05000565
UTTAR PRADESH,2002,Three Wheeler,298,57,355,27.59998069,78.05000565
UTTAR PRADESH,2002,Two Wheeler,861,178,1039,27.59998069,78.05000565
UTTAR PRADESH,2002,Bicycle,394,44,438,27.59998069,78.05000565
UTTAR PRADESH,2002,Pedestrian,614,154,768,27.59998069,78.05000565
UTTAR PRADESH,2002,Others (Please Specify),308,57,365,27.59998069,78.05000565
UTTAR PRADESH,2003,Truck/Lorry (Government),95,8,103,27.59998069,78.05000565
UTTAR PRADESH,2003,Truck/Lorry (Private),1373,202,1575,27.59998069,78.05000565
UTTAR PRADESH,2003,Bus (Government),52,9,61,27.59998069,78.05000565
UTTAR PRADESH,2003,Bus (Private),729,168,897,27.59998069,78.05000565
UTTAR PRADESH,2003,Tempo/Vans (Government),12,2,14,27.59998069,78.05000565
UTTAR PRADESH,2003,Tempo/Vans (Private),472,78,550,27.59998069,78.05000565
UTTAR PRADESH,2003,Jeep (Government),8,1,9,27.59998069,78.05000565
UTTAR PRADESH,2003,Jeep (Private),967,204,1171,27.59998069,78.05000565
UTTAR PRADESH,2003,Car (Government),9,2,11,27.59998069,78.05000565
UTTAR PRADESH,2003,Car (Private),392,69,461,27.59998069,78.05000565
UTTAR PRADESH,2003,Three Wheeler,296,52,348,27.59998069,78.05000565
UTTAR PRADESH,2003,Two Wheeler,1071,157,1228,27.59998069,78.05000565
UTTAR PRADESH,2003,Bicycle,494,15,509,27.59998069,78.05000565
UTTAR PRADESH,2003,Pedestrian,631,90,721,27.59998069,78.05000565
UTTAR PRADESH,2003,Others (Please Specify),249,30,279,27.59998069,78.05000565
UTTAR PRADESH,2004,Truck/Lorry (Government),59,15,74,27.59998069,78.05000565
UTTAR PRADESH,2004,Truck/Lorry (Private),2124,345,2469,27.59998069,78.05000565
UTTAR PRADESH,2004,Bus (Government),405,100,505,27.59998069,78.05000565
UTTAR PRADESH,2004,Bus (Private),404,76,480,27.59998069,78.05000565
UTTAR PRADESH,2004,Tempo/Vans (Government),19,4,23,27.59998069,78.05000565
UTTAR PRADESH,2004,Tempo/Vans (Private),714,142,856,27.59998069,78.05000565
UTTAR PRADESH,2004,Jeep (Government),26,5,31,27.59998069,78.05000565
UTTAR PRADESH,2004,Jeep (Private),1093,246,1339,27.59998069,78.05000565
UTTAR PRADESH,2004,Car (Government),15,3,18,27.59998069,78.05000565
UTTAR PRADESH,2004,Car (Private),507,117,624,27.59998069,78.05000565
UTTAR PRADESH,2004,Three Wheeler,315,78,393,27.59998069,78.05000565
UTTAR PRADESH,2004,Two Wheeler,1304,235,1539,27.59998069,78.05000565
UTTAR PRADESH,2004,Bicycle,631,49,680,27.59998069,78.05000565
UTTAR PRADESH,2004,Pedestrian,681,195,876,27.59998069,78.05000565
UTTAR PRADESH,2004,Others (Please Specify),229,46,275,27.59998069,78.05000565
UTTAR PRADESH,2005,Truck/Lorry (Government),123,9,132,27.59998069,78.05000565
UTTAR PRADESH,2005,Truck/Lorry (Private),1833,286,2119,27.59998069,78.05000565
UTTAR PRADESH,2005,Bus (Government),147,33,180,27.59998069,78.05000565
UTTAR PRADESH,2005,Bus (Private),748,117,865,27.59998069,78.05000565
UTTAR PRADESH,2005,Tempo/Vans (Government),29,0,29,27.59998069,78.05000565
UTTAR PRADESH,2005,Tempo/Vans (Private),679,154,833,27.59998069,78.05000565
UTTAR PRADESH,2005,Jeep (Government),39,7,46,27.59998069,78.05000565
UTTAR PRADESH,2005,Jeep (Private),1147,178,1325,27.59998069,78.05000565
UTTAR PRADESH,2005,Car (Government),17,3,20,27.59998069,78.05000565
UTTAR PRADESH,2005,Car (Private),598,102,700,27.59998069,78.05000565
UTTAR PRADESH,2005,Three Wheeler,356,62,418,27.59998069,78.05000565
UTTAR PRADESH,2005,Two Wheeler,1302,271,1573,27.59998069,78.05000565
UTTAR PRADESH,2005,Bicycle,583,60,643,27.59998069,78.05000565
UTTAR PRADESH,2005,Pedestrian,583,136,719,27.59998069,78.05000565
UTTAR PRADESH,2005,Others (Please Specify),202,56,258,27.59998069,78.05000565
UTTAR PRADESH,2006,Truck/Lorry (Government),52,12,64,27.59998069,78.05000565
UTTAR PRADESH,2006,Truck/Lorry (Private),2301,394,2695,27.59998069,78.05000565
UTTAR PRADESH,2006,Bus (Government),637,114,751,27.59998069,78.05000565
UTTAR PRADESH,2006,Bus (Private),422,72,494,27.59998069,78.05000565
UTTAR PRADESH,2006,Tempo/Vans (Government),29,10,39,27.59998069,78.05000565
UTTAR PRADESH,2006,Tempo/Vans (Private),668,149,817,27.59998069,78.05000565
UTTAR PRADESH,2006,Jeep (Government),24,6,30,27.59998069,78.05000565
UTTAR PRADESH,2006,Jeep (Private),1283,204,1487,27.59998069,78.05000565
UTTAR PRADESH,2006,Car (Government),36,24,60,27.59998069,78.05000565
UTTAR PRADESH,2006,Car (Private),562,653,1215,27.59998069,78.05000565
UTTAR PRADESH,2006,Three Wheeler,398,63,461,27.59998069,78.05000565
UTTAR PRADESH,2006,Two Wheeler,1482,242,1724,27.59998069,78.05000565
UTTAR PRADESH,2006,Bicycle,554,63,617,27.59998069,78.05000565
UTTAR PRADESH,2006,Pedestrian,614,126,740,27.59998069,78.05000565
UTTAR PRADESH,2006,Others (Please Specify),276,50,326,27.59998069,78.05000565
UTTAR PRADESH,2007,Truck/Lorry (Government),163,41,204,27.59998069,78.05000565
UTTAR PRADESH,2007,Truck/Lorry (Private),2235,319,2554,27.59998069,78.05000565
UTTAR PRADESH,2007,Bus (Government),396,50,446,27.59998069,78.05000565
UTTAR PRADESH,2007,Bus (Private),766,117,883,27.59998069,78.05000565
UTTAR PRADESH,2007,Tempo/Vans (Government),76,28,104,27.59998069,78.05000565
UTTAR PRADESH,2007,Tempo/Vans (Private),783,142,925,27.59998069,78.05000565
UTTAR PRADESH,2007,Jeep (Government),111,16,127,27.59998069,78.05000565
UTTAR PRADESH,2007,Jeep (Private),1323,219,1542,27.59998069,78.05000565
UTTAR PRADESH,2007,Car (Government),36,6,42,27.59998069,78.05000565
UTTAR PRADESH,2007,Car (Private),723,162,885,27.59998069,78.05000565
UTTAR PRADESH,2007,Three Wheeler,504,78,582,27.59998069,78.05000565
UTTAR PRADESH,2007,Two Wheeler,1814,264,2078,27.59998069,78.05000565
UTTAR PRADESH,2007,Bicycle,669,48,717,27.59998069,78.05000565
UTTAR PRADESH,2007,Pedestrian,818,119,937,27.59998069,78.05000565
UTTAR PRADESH,2007,Others (Please Specify),431,98,529,27.59998069,78.05000565
UTTAR PRADESH,2008,Truck/Lorry (Government),134,25,159,27.59998069,78.05000565
UTTAR PRADESH,2008,Truck/Lorry (Private),2365,306,2671,27.59998069,78.05000565
UTTAR PRADESH,2008,Bus (Government),372,59,431,27.59998069,78.05000565
UTTAR PRADESH,2008,Bus (Private),558,116,674,27.59998069,78.05000565
UTTAR PRADESH,2008,Tempo/Vans (Government),14,2,16,27.59998069,78.05000565
UTTAR PRADESH,2008,Tempo/Vans (Private),849,144,993,27.59998069,78.05000565
UTTAR PRADESH,2008,Jeep (Government),21,11,32,27.59998069,78.05000565
UTTAR PRADESH,2008,Jeep (Private),1270,206,1476,27.59998069,78.05000565
UTTAR PRADESH,2008,Car (Government),28,8,36,27.59998069,78.05000565
UTTAR PRADESH,2008,Car (Private),929,139,1068,27.59998069,78.05000565
UTTAR PRADESH,2008,Three Wheeler,490,87,577,27.59998069,78.05000565
UTTAR PRADESH,2008,Two Wheeler,1779,341,2120,27.59998069,78.05000565
UTTAR PRADESH,2008,Bicycle,597,67,664,27.59998069,78.05000565
UTTAR PRADESH,2008,Pedestrian,761,138,899,27.59998069,78.05000565
UTTAR PRADESH,2008,Others (Please Specify),213,44,257,27.59998069,78.05000565
UTTAR PRADESH,2009,Truck/Lorry (Government),75,9,84,27.59998069,78.05000565
UTTAR PRADESH,2009,Truck/Lorry (Private),2413,285,2698,27.59998069,78.05000565
UTTAR PRADESH,2009,Bus (Government),199,64,263,27.59998069,78.05000565
UTTAR PRADESH,2009,Bus (Private),957,150,1107,27.59998069,78.05000565
UTTAR PRADESH,2009,Tempo/Vans (Government),23,0,23,27.59998069,78.05000565
UTTAR PRADESH,2009,Tempo/Vans (Private),914,213,1127,27.59998069,78.05000565
UTTAR PRADESH,2009,Jeep (Government),25,3,28,27.59998069,78.05000565
UTTAR PRADESH,2009,Jeep (Private),1463,247,1710,27.59998069,78.05000565
UTTAR PRADESH,2009,Car (Government),10,2,12,27.59998069,78.05000565
UTTAR PRADESH,2009,Car (Private),1138,149,1287,27.59998069,78.05000565
UTTAR PRADESH,2009,Three Wheeler,551,88,639,27.59998069,78.05000565
UTTAR PRADESH,2009,Two Wheeler,2428,378,2806,27.59998069,78.05000565
UTTAR PRADESH,2009,Bicycle,732,72,804,27.59998069,78.05000565
UTTAR PRADESH,2009,Pedestrian,1083,245,1328,27.59998069,78.05000565
UTTAR PRADESH,2009,Others (Please Specify),826,87,913,27.59998069,78.05000565
UTTAR PRADESH,2010,Truck/Lorry (Government),135,8,143,27.59998069,78.05000565
UTTAR PRADESH,2010,Truck/Lorry (Private),2825,432,3257,27.59998069,78.05000565
UTTAR PRADESH,2010,Bus (Government),235,67,302,27.59998069,78.05000565
UTTAR PRADESH,2010,Bus (Private),1039,223,1262,27.59998069,78.05000565
UTTAR PRADESH,2010,Tempo/Vans (Government),37,4,41,27.59998069,78.05000565
UTTAR PRADESH,2010,Tempo/Vans (Private),1219,253,1472,27.59998069,78.05000565
UTTAR PRADESH,2010,Jeep (Government),43,11,54,27.59998069,78.05000565
UTTAR PRADESH,2010,Jeep (Private),1341,255,1596,27.59998069,78.05000565
UTTAR PRADESH,2010,Car (Government),41,1,42,27.59998069,78.05000565
UTTAR PRADESH,2010,Car (Private),1057,212,1269,27.59998069,78.05000565
UTTAR PRADESH,2010,Three Wheeler,579,115,694,27.59998069,78.05000565
UTTAR PRADESH,2010,Two Wheeler,2198,361,2559,27.59998069,78.05000565
UTTAR PRADESH,2010,Bicycle,692,87,779,27.59998069,78.05000565
UTTAR PRADESH,2010,Pedestrian,832,179,1011,27.59998069,78.05000565
UTTAR PRADESH,2010,Others (Please Specify),540,78,618,27.59998069,78.05000565
UTTAR PRADESH,2011,Truck/Lorry (Government),57,12,69,27.59998069,78.05000565
UTTAR PRADESH,2011,Truck/Lorry (Private),2699,322,3021,27.59998069,78.05000565
UTTAR PRADESH,2011,Bus (Government),270,67,337,27.59998069,78.05000565
UTTAR PRADESH,2011,Bus (Private),835,195,1030,27.59998069,78.05000565
UTTAR PRADESH,2011,Tempo/Vans (Government),43,27,70,27.59998069,78.05000565
UTTAR PRADESH,2011,Tempo/Vans (Private),1053,217,1270,27.59998069,78.05000565
UTTAR PRADESH,2011,Jeep (Government),23,4,27,27.59998069,78.05000565
UTTAR PRADESH,2011,Jeep (Private),1062,224,1286,27.59998069,78.05000565
UTTAR PRADESH,2011,Car (Government),20,3,23,27.59998069,78.05000565
UTTAR PRADESH,2011,Car (Private),1149,231,1380,27.59998069,78.05000565
UTTAR PRADESH,2011,Three Wheeler,682,148,830,27.59998069,78.05000565
UTTAR PRADESH,2011,Two Wheeler,2459,361,2820,27.59998069,78.05000565
UTTAR PRADESH,2011,Bicycle,701,110,811,27.59998069,78.05000565
UTTAR PRADESH,2011,Pedestrian,1118,297,1415,27.59998069,78.05000565
UTTAR PRADESH,2011,Others (Please Specify),502,105,607,27.59998069,78.05000565
UTTAR PRADESH,2012,Truck/Lorry (Government),192,27,219,27.59998069,78.05000565
UTTAR PRADESH,2012,Truck/Lorry (Private),2968,384,3352,27.59998069,78.05000565
UTTAR PRADESH,2012,Bus (Government),593,107,700,27.59998069,78.05000565
UTTAR PRADESH,2012,Bus (Private),894,190,1084,27.59998069,78.05000565
UTTAR PRADESH,2012,Tempo/Vans (Government),19,8,27,27.59998069,78.05000565
UTTAR PRADESH,2012,Tempo/Vans (Private),907,261,1168,27.59998069,78.05000565
UTTAR PRADESH,2012,Jeep (Government),88,5,93,27.59998069,78.05000565
UTTAR PRADESH,2012,Jeep (Private),1128,262,1390,27.59998069,78.05000565
UTTAR PRADESH,2012,Car (Government),60,7,67,27.59998069,78.05000565
UTTAR PRADESH,2012,Car (Private),1078,184,1262,27.59998069,78.05000565
UTTAR PRADESH,2012,Three Wheeler,758,155,913,27.59998069,78.05000565
UTTAR PRADESH,2012,Two Wheeler,2328,360,2688,27.59998069,78.05000565
UTTAR PRADESH,2012,Bicycle,559,52,611,27.59998069,78.05000565
UTTAR PRADESH,2012,Pedestrian,672,126,798,27.59998069,78.05000565
UTTAR PRADESH,2012,Others (Please Specify),643,94,737,27.59998069,78.05000565
UTTARAKHAND,2001,Truck/Lorry (Government),8,1,9,30.32040895,78.05000565
UTTARAKHAND,2001,Truck/Lorry (Private),98,12,110,30.32040895,78.05000565
UTTARAKHAND,2001,Bus (Government),0,0,0,30.32040895,78.05000565
UTTARAKHAND,2001,Bus (Private),111,38,149,30.32040895,78.05000565
UTTARAKHAND,2001,Tempo/Vans (Government),0,0,0,30.32040895,78.05000565
UTTARAKHAND,2001,Tempo/Vans (Private),42,14,56,30.32040895,78.05000565
UTTARAKHAND,2001,Jeep (Government),1,2,3,30.32040895,78.05000565
UTTARAKHAND,2001,Jeep (Private),110,34,144,30.32040895,78.05000565
UTTARAKHAND,2001,Car (Government),0,0,0,30.32040895,78.05000565
UTTARAKHAND,2001,Car (Private),39,8,47,30.32040895,78.05000565
UTTARAKHAND,2001,Three Wheeler,51,13,64,30.32040895,78.05000565
UTTARAKHAND,2001,Two Wheeler,78,10,88,30.32040895,78.05000565
UTTARAKHAND,2001,Bicycle,7,0,7,30.32040895,78.05000565
UTTARAKHAND,2001,Pedestrian,30,6,36,30.32040895,78.05000565
UTTARAKHAND,2001,Others (Please Specify),48,20,68,30.32040895,78.05000565
UTTARAKHAND,2002,Truck/Lorry (Government),15,0,15,30.32040895,78.05000565
UTTARAKHAND,2002,Truck/Lorry (Private),157,4,161,30.32040895,78.05000565
UTTARAKHAND,2002,Bus (Government),0,0,0,30.32040895,78.05000565
UTTARAKHAND,2002,Bus (Private),115,35,150,30.32040895,78.05000565
UTTARAKHAND,2002,Tempo/Vans (Government),1,0,1,30.32040895,78.05000565
UTTARAKHAND,2002,Tempo/Vans (Private),33,5,38,30.32040895,78.05000565
UTTARAKHAND,2002,Jeep (Government),3,3,6,30.32040895,78.05000565
UTTARAKHAND,2002,Jeep (Private),92,10,102,30.32040895,78.05000565
UTTARAKHAND,2002,Car (Government),0,1,1,30.32040895,78.05000565
UTTARAKHAND,2002,Car (Private),36,9,45,30.32040895,78.05000565
UTTARAKHAND,2002,Three Wheeler,14,2,16,30.32040895,78.05000565
UTTARAKHAND,2002,Two Wheeler,56,7,63,30.32040895,78.05000565
UTTARAKHAND,2002,Bicycle,7,0,7,30.32040895,78.05000565
UTTARAKHAND,2002,Pedestrian,38,10,48,30.32040895,78.05000565
UTTARAKHAND,2002,Others (Please Specify),47,5,52,30.32040895,78.05000565
UTTARAKHAND,2003,Truck/Lorry (Government),0,0,0,30.32040895,78.05000565
UTTARAKHAND,2003,Truck/Lorry (Private),149,10,159,30.32040895,78.05000565
UTTARAKHAND,2003,Bus (Government),8,1,9,30.32040895,78.05000565
UTTARAKHAND,2003,Bus (Private),72,24,96,30.32040895,78.05000565
UTTARAKHAND,2003,Tempo/Vans (Government),0,0,0,30.32040895,78.05000565
UTTARAKHAND,2003,Tempo/Vans (Private),25,0,25,30.32040895,78.05000565
UTTARAKHAND,2003,Jeep (Government),1,0,1,30.32040895,78.05000565
UTTARAKHAND,2003,Jeep (Private),132,31,163,30.32040895,78.05000565
UTTARAKHAND,2003,Car (Government),0,0,0,30.32040895,78.05000565
UTTARAKHAND,2003,Car (Private),75,29,104,30.32040895,78.05000565
UTTARAKHAND,2003,Three Wheeler,9,2,11,30.32040895,78.05000565
UTTARAKHAND,2003,Two Wheeler,52,2,54,30.32040895,78.05000565
UTTARAKHAND,2003,Bicycle,4,0,4,30.32040895,78.05000565
UTTARAKHAND,2003,Pedestrian,24,4,28,30.32040895,78.05000565
UTTARAKHAND,2003,Others (Please Specify),56,10,66,30.32040895,78.05000565
UTTARAKHAND,2004,Truck/Lorry (Government),5,0,5,30.32040895,78.05000565
UTTARAKHAND,2004,Truck/Lorry (Private),211,13,224,30.32040895,78.05000565
UTTARAKHAND,2004,Bus (Government),33,6,39,30.32040895,78.05000565
UTTARAKHAND,2004,Bus (Private),170,27,197,30.32040895,78.05000565
UTTARAKHAND,2004,Tempo/Vans (Government),0,0,0,30.32040895,78.05000565
UTTARAKHAND,2004,Tempo/Vans (Private),62,9,71,30.32040895,78.05000565
UTTARAKHAND,2004,Jeep (Government),3,0,3,30.32040895,78.05000565
UTTARAKHAND,2004,Jeep (Private),93,11,104,30.32040895,78.05000565
UTTARAKHAND,2004,Car (Government),1,0,1,30.32040895,78.05000565
UTTARAKHAND,2004,Car (Private),66,10,76,30.32040895,78.05000565
UTTARAKHAND,2004,Three Wheeler,14,1,15,30.32040895,78.05000565
UTTARAKHAND,2004,Two Wheeler,79,5,84,30.32040895,78.05000565
UTTARAKHAND,2004,Bicycle,8,1,9,30.32040895,78.05000565
UTTARAKHAND,2004,Pedestrian,15,4,19,30.32040895,78.05000565
UTTARAKHAND,2004,Others (Please Specify),71,13,84,30.32040895,78.05000565
UTTARAKHAND,2005,Truck/Lorry (Government),6,0,6,30.32040895,78.05000565
UTTARAKHAND,2005,Truck/Lorry (Private),157,22,179,30.32040895,78.05000565
UTTARAKHAND,2005,Bus (Government),8,3,11,30.32040895,78.05000565
UTTARAKHAND,2005,Bus (Private),158,27,185,30.32040895,78.05000565
UTTARAKHAND,2005,Tempo/Vans (Government),0,0,0,30.32040895,78.05000565
UTTARAKHAND,2005,Tempo/Vans (Private),33,4,37,30.32040895,78.05000565
UTTARAKHAND,2005,Jeep (Government),0,1,1,30.32040895,78.05000565
UTTARAKHAND,2005,Jeep (Private),87,22,109,30.32040895,78.05000565
UTTARAKHAND,2005,Car (Government),9,0,9,30.32040895,78.05000565
UTTARAKHAND,2005,Car (Private),79,8,87,30.32040895,78.05000565
UTTARAKHAND,2005,Three Wheeler,34,2,36,30.32040895,78.05000565
UTTARAKHAND,2005,Two Wheeler,55,2,57,30.32040895,78.05000565
UTTARAKHAND,2005,Bicycle,8,0,8,30.32040895,78.05000565
UTTARAKHAND,2005,Pedestrian,29,9,38,30.32040895,78.05000565
UTTARAKHAND,2005,Others (Please Specify),95,11,106,30.32040895,78.05000565
UTTARAKHAND,2006,Truck/Lorry (Government),4,0,4,30.32040895,78.05000565
UTTARAKHAND,2006,Truck/Lorry (Private),207,37,244,30.32040895,78.05000565
UTTARAKHAND,2006,Bus (Government),5,0,5,30.32040895,78.05000565
UTTARAKHAND,2006,Bus (Private),143,33,176,30.32040895,78.05000565
UTTARAKHAND,2006,Tempo/Vans (Government),0,0,0,30.32040895,78.05000565
UTTARAKHAND,2006,Tempo/Vans (Private),35,9,44,30.32040895,78.05000565
UTTARAKHAND,2006,Jeep (Government),0,1,1,30.32040895,78.05000565
UTTARAKHAND,2006,Jeep (Private),81,13,94,30.32040895,78.05000565
UTTARAKHAND,2006,Car (Government),0,0,0,30.32040895,78.05000565
UTTARAKHAND,2006,Car (Private),78,17,95,30.32040895,78.05000565
UTTARAKHAND,2006,Three Wheeler,16,5,21,30.32040895,78.05000565
UTTARAKHAND,2006,Two Wheeler,89,5,94,30.32040895,78.05000565
UTTARAKHAND,2006,Bicycle,9,0,9,30.32040895,78.05000565
UTTARAKHAND,2006,Pedestrian,21,5,26,30.32040895,78.05000565
UTTARAKHAND,2006,Others (Please Specify),134,28,162,30.32040895,78.05000565
UTTARAKHAND,2007,Truck/Lorry (Government),0,0,0,30.32040895,78.05000565
UTTARAKHAND,2007,Truck/Lorry (Private),187,28,215,30.32040895,78.05000565
UTTARAKHAND,2007,Bus (Government),3,0,3,30.32040895,78.05000565
UTTARAKHAND,2007,Bus (Private),142,63,205,30.32040895,78.05000565
UTTARAKHAND,2007,Tempo/Vans (Government),0,0,0,30.32040895,78.05000565
UTTARAKHAND,2007,Tempo/Vans (Private),31,9,40,30.32040895,78.05000565
UTTARAKHAND,2007,Jeep (Government),0,0,0,30.32040895,78.05000565
UTTARAKHAND,2007,Jeep (Private),86,29,115,30.32040895,78.05000565
UTTARAKHAND,2007,Car (Government),0,0,0,30.32040895,78.05000565
UTTARAKHAND,2007,Car (Private),87,25,112,30.32040895,78.05000565
UTTARAKHAND,2007,Three Wheeler,24,8,32,30.32040895,78.05000565
UTTARAKHAND,2007,Two Wheeler,78,4,82,30.32040895,78.05000565
UTTARAKHAND,2007,Bicycle,3,0,3,30.32040895,78.05000565
UTTARAKHAND,2007,Pedestrian,27,2,29,30.32040895,78.05000565
UTTARAKHAND,2007,Others (Please Specify),118,19,137,30.32040895,78.05000565
UTTARAKHAND,2008,Truck/Lorry (Government),10,0,10,30.32040895,78.05000565
UTTARAKHAND,2008,Truck/Lorry (Private),183,21,204,30.32040895,78.05000565
UTTARAKHAND,2008,Bus (Government),24,5,29,30.32040895,78.05000565
UTTARAKHAND,2008,Bus (Private),145,54,199,30.32040895,78.05000565
UTTARAKHAND,2008,Tempo/Vans (Government),2,2,4,30.32040895,78.05000565
UTTARAKHAND,2008,Tempo/Vans (Private),79,14,93,30.32040895,78.05000565
UTTARAKHAND,2008,Jeep (Government),12,2,14,30.32040895,78.05000565
UTTARAKHAND,2008,Jeep (Private),91,21,112,30.32040895,78.05000565
UTTARAKHAND,2008,Car (Government),0,0,0,30.32040895,78.05000565
UTTARAKHAND,2008,Car (Private),77,21,98,30.32040895,78.05000565
UTTARAKHAND,2008,Three Wheeler,38,4,42,30.32040895,78.05000565
UTTARAKHAND,2008,Two Wheeler,84,18,102,30.32040895,78.05000565
UTTARAKHAND,2008,Bicycle,8,1,9,30.32040895,78.05000565
UTTARAKHAND,2008,Pedestrian,40,4,44,30.32040895,78.05000565
UTTARAKHAND,2008,Others (Please Specify),88,19,107,30.32040895,78.05000565
UTTARAKHAND,2009,Truck/Lorry (Government),1,0,1,30.32040895,78.05000565
UTTARAKHAND,2009,Truck/Lorry (Private),167,13,180,30.32040895,78.05000565
UTTARAKHAND,2009,Bus (Government),0,0,0,30.32040895,78.05000565
UTTARAKHAND,2009,Bus (Private),109,26,135,30.32040895,78.05000565
UTTARAKHAND,2009,Tempo/Vans (Government),0,0,0,30.32040895,78.05000565
UTTARAKHAND,2009,Tempo/Vans (Private),40,5,45,30.32040895,78.05000565
UTTARAKHAND,2009,Jeep (Government),2,0,2,30.32040895,78.05000565
UTTARAKHAND,2009,Jeep (Private),91,16,107,30.32040895,78.05000565
UTTARAKHAND,2009,Car (Government),6,4,10,30.32040895,78.05000565
UTTARAKHAND,2009,Car (Private),40,8,48,30.32040895,78.05000565
UTTARAKHAND,2009,Three Wheeler,15,3,18,30.32040895,78.05000565
UTTARAKHAND,2009,Two Wheeler,87,9,96,30.32040895,78.05000565
UTTARAKHAND,2009,Bicycle,17,0,17,30.32040895,78.05000565
UTTARAKHAND,2009,Pedestrian,43,2,45,30.32040895,78.05000565
UTTARAKHAND,2009,Others (Please Specify),139,9,148,30.32040895,78.05000565
UTTARAKHAND,2010,Truck/Lorry (Government),11,0,11,30.32040895,78.05000565
UTTARAKHAND,2010,Truck/Lorry (Private),94,12,106,30.32040895,78.05000565
UTTARAKHAND,2010,Bus (Government),10,2,12,30.32040895,78.05000565
UTTARAKHAND,2010,Bus (Private),77,14,91,30.32040895,78.05000565
UTTARAKHAND,2010,Tempo/Vans (Government),0,0,0,30.32040895,78.05000565
UTTARAKHAND,2010,Tempo/Vans (Private),43,8,51,30.32040895,78.05000565
UTTARAKHAND,2010,Jeep (Government),8,0,8,30.32040895,78.05000565
UTTARAKHAND,2010,Jeep (Private),53,18,71,30.32040895,78.05000565
UTTARAKHAND,2010,Car (Government),41,3,44,30.32040895,78.05000565
UTTARAKHAND,2010,Car (Private),86,35,121,30.32040895,78.05000565
UTTARAKHAND,2010,Three Wheeler,25,9,34,30.32040895,78.05000565
UTTARAKHAND,2010,Two Wheeler,175,21,196,30.32040895,78.05000565
UTTARAKHAND,2010,Bicycle,21,3,24,30.32040895,78.05000565
UTTARAKHAND,2010,Pedestrian,55,8,63,30.32040895,78.05000565
UTTARAKHAND,2010,Others (Please Specify),80,5,85,30.32040895,78.05000565
UTTARAKHAND,2011,Truck/Lorry (Government),12,0,12,30.32040895,78.05000565
UTTARAKHAND,2011,Truck/Lorry (Private),158,13,171,30.32040895,78.05000565
UTTARAKHAND,2011,Bus (Government),0,0,0,30.32040895,78.05000565
UTTARAKHAND,2011,Bus (Private),20,33,53,30.32040895,78.05000565
UTTARAKHAND,2011,Tempo/Vans (Government),0,0,0,30.32040895,78.05000565
UTTARAKHAND,2011,Tempo/Vans (Private),138,22,160,30.32040895,78.05000565
UTTARAKHAND,2011,Jeep (Government),8,0,8,30.32040895,78.05000565
UTTARAKHAND,2011,Jeep (Private),23,5,28,30.32040895,78.05000565
UTTARAKHAND,2011,Car (Government),17,3,20,30.32040895,78.05000565
UTTARAKHAND,2011,Car (Private),65,14,79,30.32040895,78.05000565
UTTARAKHAND,2011,Three Wheeler,3,16,19,30.32040895,78.05000565
UTTARAKHAND,2011,Two Wheeler,161,14,175,30.32040895,78.05000565
UTTARAKHAND,2011,Bicycle,12,1,13,30.32040895,78.05000565
UTTARAKHAND,2011,Pedestrian,21,2,23,30.32040895,78.05000565
UTTARAKHAND,2011,Others (Please Specify),137,24,161,30.32040895,78.05000565
UTTARAKHAND,2012,Truck/Lorry (Government),2,0,2,30.32040895,78.05000565
UTTARAKHAND,2012,Truck/Lorry (Private),100,25,125,30.32040895,78.05000565
UTTARAKHAND,2012,Bus (Government),21,5,26,30.32040895,78.05000565
UTTARAKHAND,2012,Bus (Private),66,29,95,30.32040895,78.05000565
UTTARAKHAND,2012,Tempo/Vans (Government),2,0,2,30.32040895,78.05000565
UTTARAKHAND,2012,Tempo/Vans (Private),11,1,12,30.32040895,78.05000565
UTTARAKHAND,2012,Jeep (Government),1,0,1,30.32040895,78.05000565
UTTARAKHAND,2012,Jeep (Private),49,13,62,30.32040895,78.05000565
UTTARAKHAND,2012,Car (Government),3,1,4,30.32040895,78.05000565
UTTARAKHAND,2012,Car (Private),107,20,127,30.32040895,78.05000565
UTTARAKHAND,2012,Three Wheeler,10,7,17,30.32040895,78.05000565
UTTARAKHAND,2012,Two Wheeler,168,10,178,30.32040895,78.05000565
UTTARAKHAND,2012,Bicycle,19,2,21,30.32040895,78.05000565
UTTARAKHAND,2012,Pedestrian,66,9,75,30.32040895,78.05000565
UTTARAKHAND,2012,Others (Please Specify),65,15,80,30.32040895,78.05000565
WEST BENGAL,2001,Truck/Lorry (Government),37,6,43,22.58039044,88.32994665
WEST BENGAL,2001,Truck/Lorry (Private),747,214,961,22.58039044,88.32994665
WEST BENGAL,2001,Bus (Government),106,58,164,22.58039044,88.32994665
WEST BENGAL,2001,Bus (Private),701,327,1028,22.58039044,88.32994665
WEST BENGAL,2001,Tempo/Vans (Government),7,0,7,22.58039044,88.32994665
WEST BENGAL,2001,Tempo/Vans (Private),151,79,230,22.58039044,88.32994665
WEST BENGAL,2001,Jeep (Government),17,1,18,22.58039044,88.32994665
WEST BENGAL,2001,Jeep (Private),118,52,170,22.58039044,88.32994665
WEST BENGAL,2001,Car (Government),17,3,20,22.58039044,88.32994665
WEST BENGAL,2001,Car (Private),253,100,353,22.58039044,88.32994665
WEST BENGAL,2001,Three Wheeler,32,26,58,22.58039044,88.32994665
WEST BENGAL,2001,Two Wheeler,155,35,190,22.58039044,88.32994665
WEST BENGAL,2001,Bicycle,66,7,73,22.58039044,88.32994665
WEST BENGAL,2001,Pedestrian,94,52,146,22.58039044,88.32994665
WEST BENGAL,2001,Others (Please Specify),326,172,498,22.58039044,88.32994665
WEST BENGAL,2002,Truck/Lorry (Government),155,56,211,22.58039044,88.32994665
WEST BENGAL,2002,Truck/Lorry (Private),715,256,971,22.58039044,88.32994665
WEST BENGAL,2002,Bus (Government),100,35,135,22.58039044,88.32994665
WEST BENGAL,2002,Bus (Private),698,265,963,22.58039044,88.32994665
WEST BENGAL,2002,Tempo/Vans (Government),5,3,8,22.58039044,88.32994665
WEST BENGAL,2002,Tempo/Vans (Private),120,87,207,22.58039044,88.32994665
WEST BENGAL,2002,Jeep (Government),19,6,25,22.58039044,88.32994665
WEST BENGAL,2002,Jeep (Private),161,46,207,22.58039044,88.32994665
WEST BENGAL,2002,Car (Government),4,3,7,22.58039044,88.32994665
WEST BENGAL,2002,Car (Private),222,92,314,22.58039044,88.32994665
WEST BENGAL,2002,Three Wheeler,44,25,69,22.58039044,88.32994665
WEST BENGAL,2002,Two Wheeler,178,69,247,22.58039044,88.32994665
WEST BENGAL,2002,Bicycle,84,12,96,22.58039044,88.32994665
WEST BENGAL,2002,Pedestrian,179,64,243,22.58039044,88.32994665
WEST BENGAL,2002,Others (Please Specify),305,131,436,22.58039044,88.32994665
WEST BENGAL,2003,Truck/Lorry (Government),19,4,23,22.58039044,88.32994665
WEST BENGAL,2003,Truck/Lorry (Private),1122,271,1393,22.58039044,88.32994665
WEST BENGAL,2003,Bus (Government),91,34,125,22.58039044,88.32994665
WEST BENGAL,2003,Bus (Private),702,225,927,22.58039044,88.32994665
WEST BENGAL,2003,Tempo/Vans (Government),0,0,0,22.58039044,88.32994665
WEST BENGAL,2003,Tempo/Vans (Private),301,75,376,22.58039044,88.32994665
WEST BENGAL,2003,Jeep (Government),19,4,23,22.58039044,88.32994665
WEST BENGAL,2003,Jeep (Private),185,41,226,22.58039044,88.32994665
WEST BENGAL,2003,Car (Government),3,1,4,22.58039044,88.32994665
WEST BENGAL,2003,Car (Private),222,75,297,22.58039044,88.32994665
WEST BENGAL,2003,Three Wheeler,64,12,76,22.58039044,88.32994665
WEST BENGAL,2003,Two Wheeler,299,59,358,22.58039044,88.32994665
WEST BENGAL,2003,Bicycle,45,2,47,22.58039044,88.32994665
WEST BENGAL,2003,Pedestrian,52,23,75,22.58039044,88.32994665
WEST BENGAL,2003,Others (Please Specify),128,49,177,22.58039044,88.32994665
WEST BENGAL,2004,Truck/Lorry (Government),13,4,17,22.58039044,88.32994665
WEST BENGAL,2004,Truck/Lorry (Private),920,274,1194,22.58039044,88.32994665
WEST BENGAL,2004,Bus (Government),80,30,110,22.58039044,88.32994665
WEST BENGAL,2004,Bus (Private),646,248,894,22.58039044,88.32994665
WEST BENGAL,2004,Tempo/Vans (Government),7,1,8,22.58039044,88.32994665
WEST BENGAL,2004,Tempo/Vans (Private),194,86,280,22.58039044,88.32994665
WEST BENGAL,2004,Jeep (Government),7,0,7,22.58039044,88.32994665
WEST BENGAL,2004,Jeep (Private),174,68,242,22.58039044,88.32994665
WEST BENGAL,2004,Car (Government),15,3,18,22.58039044,88.32994665
WEST BENGAL,2004,Car (Private),342,128,470,22.58039044,88.32994665
WEST BENGAL,2004,Three Wheeler,60,17,77,22.58039044,88.32994665
WEST BENGAL,2004,Two Wheeler,252,65,317,22.58039044,88.32994665
WEST BENGAL,2004,Bicycle,45,1,46,22.58039044,88.32994665
WEST BENGAL,2004,Pedestrian,155,54,209,22.58039044,88.32994665
WEST BENGAL,2004,Others (Please Specify),235,145,380,22.58039044,88.32994665
WEST BENGAL,2005,Truck/Lorry (Government),12,2,14,22.58039044,88.32994665
WEST BENGAL,2005,Truck/Lorry (Private),1024,248,1272,22.58039044,88.32994665
WEST BENGAL,2005,Bus (Government),54,14,68,22.58039044,88.32994665
WEST BENGAL,2005,Bus (Private),802,243,1045,22.58039044,88.32994665
WEST BENGAL,2005,Tempo/Vans (Government),2,0,2,22.58039044,88.32994665
WEST BENGAL,2005,Tempo/Vans (Private),170,52,222,22.58039044,88.32994665
WEST BENGAL,2005,Jeep (Government),12,1,13,22.58039044,88.32994665
WEST BENGAL,2005,Jeep (Private),177,55,232,22.58039044,88.32994665
WEST BENGAL,2005,Car (Government),4,1,5,22.58039044,88.32994665
WEST BENGAL,2005,Car (Private),275,84,359,22.58039044,88.32994665
WEST BENGAL,2005,Three Wheeler,40,10,50,22.58039044,88.32994665
WEST BENGAL,2005,Two Wheeler,269,64,333,22.58039044,88.32994665
WEST BENGAL,2005,Bicycle,32,4,36,22.58039044,88.32994665
WEST BENGAL,2005,Pedestrian,292,78,370,22.58039044,88.32994665
WEST BENGAL,2005,Others (Please Specify),242,101,343,22.58039044,88.32994665
WEST BENGAL,2006,Truck/Lorry (Government),24,8,32,22.58039044,88.32994665
WEST BENGAL,2006,Truck/Lorry (Private),1301,295,1596,22.58039044,88.32994665
WEST BENGAL,2006,Bus (Government),45,14,59,22.58039044,88.32994665
WEST BENGAL,2006,Bus (Private),697,201,898,22.58039044,88.32994665
WEST BENGAL,2006,Tempo/Vans (Government),1,0,1,22.58039044,88.32994665
WEST BENGAL,2006,Tempo/Vans (Private),320,93,413,22.58039044,88.32994665
WEST BENGAL,2006,Jeep (Government),23,7,30,22.58039044,88.32994665
WEST BENGAL,2006,Jeep (Private),202,98,300,22.58039044,88.32994665
WEST BENGAL,2006,Car (Government),1,0,1,22.58039044,88.32994665
WEST BENGAL,2006,Car (Private),310,99,409,22.58039044,88.32994665
WEST BENGAL,2006,Three Wheeler,47,6,53,22.58039044,88.32994665
WEST BENGAL,2006,Two Wheeler,274,71,345,22.58039044,88.32994665
WEST BENGAL,2006,Bicycle,46,2,48,22.58039044,88.32994665
WEST BENGAL,2006,Pedestrian,285,79,364,22.58039044,88.32994665
WEST BENGAL,2006,Others (Please Specify),7,1,8,22.58039044,88.32994665
WEST BENGAL,2007,Truck/Lorry (Government),19,4,23,22.58039044,88.32994665
WEST BENGAL,2007,Truck/Lorry (Private),1253,267,1520,22.58039044,88.32994665
WEST BENGAL,2007,Bus (Government),51,8,59,22.58039044,88.32994665
WEST BENGAL,2007,Bus (Private),695,229,924,22.58039044,88.32994665
WEST BENGAL,2007,Tempo/Vans (Government),4,1,5,22.58039044,88.32994665
WEST BENGAL,2007,Tempo/Vans (Private),95,16,111,22.58039044,88.32994665
WEST BENGAL,2007,Jeep (Government),9,0,9,22.58039044,88.32994665
WEST BENGAL,2007,Jeep (Private),197,51,248,22.58039044,88.32994665
WEST BENGAL,2007,Car (Government),12,1,13,22.58039044,88.32994665
WEST BENGAL,2007,Car (Private),331,93,424,22.58039044,88.32994665
WEST BENGAL,2007,Three Wheeler,60,4,64,22.58039044,88.32994665
WEST BENGAL,2007,Two Wheeler,411,92,503,22.58039044,88.32994665
WEST BENGAL,2007,Bicycle,94,8,102,22.58039044,88.32994665
WEST BENGAL,2007,Pedestrian,370,112,482,22.58039044,88.32994665
WEST BENGAL,2007,Others (Please Specify),371,61,432,22.58039044,88.32994665
WEST BENGAL,2008,Truck/Lorry (Government),14,1,15,22.58039044,88.32994665
WEST BENGAL,2008,Truck/Lorry (Private),1321,218,1539,22.58039044,88.32994665
WEST BENGAL,2008,Bus (Government),51,16,67,22.58039044,88.32994665
WEST BENGAL,2008,Bus (Private),657,228,885,22.58039044,88.32994665
WEST BENGAL,2008,Tempo/Vans (Government),2,0,2,22.58039044,88.32994665
WEST BENGAL,2008,Tempo/Vans (Private),99,23,122,22.58039044,88.32994665
WEST BENGAL,2008,Jeep (Government),18,6,24,22.58039044,88.32994665
WEST BENGAL,2008,Jeep (Private),152,29,181,22.58039044,88.32994665
WEST BENGAL,2008,Car (Government),37,17,54,22.58039044,88.32994665
WEST BENGAL,2008,Car (Private),357,67,424,22.58039044,88.32994665
WEST BENGAL,2008,Three Wheeler,74,18,92,22.58039044,88.32994665
WEST BENGAL,2008,Two Wheeler,430,92,522,22.58039044,88.32994665
WEST BENGAL,2008,Bicycle,0,0,0,22.58039044,88.32994665
WEST BENGAL,2008,Pedestrian,0,0,0,22.58039044,88.32994665
WEST BENGAL,2008,Others (Please Specify),630,182,812,22.58039044,88.32994665
WEST BENGAL,2009,Truck/Lorry (Government),2,3,5,22.58039044,88.32994665
WEST BENGAL,2009,Truck/Lorry (Private),1147,183,1330,22.58039044,88.32994665
WEST BENGAL,2009,Bus (Government),55,11,66,22.58039044,88.32994665
WEST BENGAL,2009,Bus (Private),558,185,743,22.58039044,88.32994665
WEST BENGAL,2009,Tempo/Vans (Government),1,0,1,22.58039044,88.32994665
WEST BENGAL,2009,Tempo/Vans (Private),193,36,229,22.58039044,88.32994665
WEST BENGAL,2009,Jeep (Government),4,1,5,22.58039044,88.32994665
WEST BENGAL,2009,Jeep (Private),126,21,147,22.58039044,88.32994665
WEST BENGAL,2009,Car (Government),5,0,5,22.58039044,88.32994665
WEST BENGAL,2009,Car (Private),336,88,424,22.58039044,88.32994665
WEST BENGAL,2009,Three Wheeler,77,14,91,22.58039044,88.32994665
WEST BENGAL,2009,Two Wheeler,457,101,558,22.58039044,88.32994665
WEST BENGAL,2009,Bicycle,127,13,140,22.58039044,88.32994665
WEST BENGAL,2009,Pedestrian,567,132,699,22.58039044,88.32994665
WEST BENGAL,2009,Others (Please Specify),476,95,571,22.58039044,88.32994665
WEST BENGAL,2010,Truck/Lorry (Government),7,9,16,22.58039044,88.32994665
WEST BENGAL,2010,Truck/Lorry (Private),1294,308,1602,22.58039044,88.32994665
WEST BENGAL,2010,Bus (Government),59,23,82,22.58039044,88.32994665
WEST BENGAL,2010,Bus (Private),546,202,748,22.58039044,88.32994665
WEST BENGAL,2010,Tempo/Vans (Government),8,2,10,22.58039044,88.32994665
WEST BENGAL,2010,Tempo/Vans (Private),168,28,196,22.58039044,88.32994665
WEST BENGAL,2010,Jeep (Government),14,5,19,22.58039044,88.32994665
WEST BENGAL,2010,Jeep (Private),127,53,180,22.58039044,88.32994665
WEST BENGAL,2010,Car (Government),4,0,4,22.58039044,88.32994665
WEST BENGAL,2010,Car (Private),323,113,436,22.58039044,88.32994665
WEST BENGAL,2010,Three Wheeler,93,15,108,22.58039044,88.32994665
WEST BENGAL,2010,Two Wheeler,562,117,679,22.58039044,88.32994665
WEST BENGAL,2010,Bicycle,142,19,161,22.58039044,88.32994665
WEST BENGAL,2010,Pedestrian,495,131,626,22.58039044,88.32994665
WEST BENGAL,2010,Others (Please Specify),467,136,603,22.58039044,88.32994665
WEST BENGAL,2011,Truck/Lorry (Government),3,2,5,22.58039044,88.32994665
WEST BENGAL,2011,Truck/Lorry (Private),1262,267,1529,22.58039044,88.32994665
WEST BENGAL,2011,Bus (Government),73,16,89,22.58039044,88.32994665
WEST BENGAL,2011,Bus (Private),585,182,767,22.58039044,88.32994665
WEST BENGAL,2011,Tempo/Vans (Government),9,2,11,22.58039044,88.32994665
WEST BENGAL,2011,Tempo/Vans (Private),236,42,278,22.58039044,88.32994665
WEST BENGAL,2011,Jeep (Government),8,3,11,22.58039044,88.32994665
WEST BENGAL,2011,Jeep (Private),112,35,147,22.58039044,88.32994665
WEST BENGAL,2011,Car (Government),11,1,12,22.58039044,88.32994665
WEST BENGAL,2011,Car (Private),400,91,491,22.58039044,88.32994665
WEST BENGAL,2011,Three Wheeler,91,23,114,22.58039044,88.32994665
WEST BENGAL,2011,Two Wheeler,708,136,844,22.58039044,88.32994665
WEST BENGAL,2011,Bicycle,97,15,112,22.58039044,88.32994665
WEST BENGAL,2011,Pedestrian,422,89,511,22.58039044,88.32994665
WEST BENGAL,2011,Others (Please Specify),591,134,725,22.58039044,88.32994665
WEST BENGAL,2012,Truck/Lorry (Government),14,6,20,22.58039044,88.32994665
WEST BENGAL,2012,Truck/Lorry (Private),1431,330,1761,22.58039044,88.32994665
WEST BENGAL,2012,Bus (Government),72,27,99,22.58039044,88.32994665
WEST BENGAL,2012,Bus (Private),464,177,641,22.58039044,88.32994665
WEST BENGAL,2012,Tempo/Vans (Government),5,1,6,22.58039044,88.32994665
WEST BENGAL,2012,Tempo/Vans (Private),191,39,230,22.58039044,88.32994665
WEST BENGAL,2012,Jeep (Government),9,3,12,22.58039044,88.32994665
WEST BENGAL,2012,Jeep (Private),147,42,189,22.58039044,88.32994665
WEST BENGAL,2012,Car (Government),12,1,13,22.58039044,88.32994665
WEST BENGAL,2012,Car (Private),437,103,540,22.58039044,88.32994665
WEST BENGAL,2012,Three Wheeler,77,27,104,22.58039044,88.32994665
WEST BENGAL,2012,Two Wheeler,852,143,995,22.58039044,88.32994665
WEST BENGAL,2012,Bicycle,184,16,200,22.58039044,88.32994665
WEST BENGAL,2012,Pedestrian,521,145,666,22.58039044,88.32994665
WEST BENGAL,2012,Others (Please Specify),543,203,746,22.58039044,88.32994665
Andaman And Nicobar,2001,Truck/Lorry (Government),2,0,2,11.66702557,92.73598262
Andaman And Nicobar,2001,Truck/Lorry (Private),3,0,3,11.66702557,92.73598262
Andaman And Nicobar,2001,Bus (Government),1,0,1,11.66702557,92.73598262
Andaman And Nicobar,2001,Bus (Private),1,0,1,11.66702557,92.73598262
Andaman And Nicobar,2001,Tempo/Vans (Government),0,0,0,11.66702557,92.73598262
Andaman And Nicobar,2001,Tempo/Vans (Private),2,0,2,11.66702557,92.73598262
Andaman And Nicobar,2001,Jeep (Government),0,0,0,11.66702557,92.73598262
Andaman And Nicobar,2001,Jeep (Private),0,0,0,11.66702557,92.73598262
Andaman And Nicobar,2001,Car (Government),0,0,0,11.66702557,92.73598262
Andaman And Nicobar,2001,Car (Private),1,0,1,11.66702557,92.73598262
Andaman And Nicobar,2001,Three Wheeler,1,0,1,11.66702557,92.73598262
Andaman And Nicobar,2001,Two Wheeler,3,1,4,11.66702557,92.73598262
Andaman And Nicobar,2001,Bicycle,0,0,0,11.66702557,92.73598262
Andaman And Nicobar,2001,Pedestrian,0,0,0,11.66702557,92.73598262
Andaman And Nicobar,2001,Others (Please Specify),2,0,2,11.66702557,92.73598262
Andaman And Nicobar,2002,Truck/Lorry (Government),0,0,0,11.66702557,92.73598262
Andaman And Nicobar,2002,Truck/Lorry (Private),4,0,4,11.66702557,92.73598262
Andaman And Nicobar,2002,Bus (Government),0,0,0,11.66702557,92.73598262
Andaman And Nicobar,2002,Bus (Private),4,2,6,11.66702557,92.73598262
Andaman And Nicobar,2002,Tempo/Vans (Government),0,0,0,11.66702557,92.73598262
Andaman And Nicobar,2002,Tempo/Vans (Private),1,0,1,11.66702557,92.73598262
Andaman And Nicobar,2002,Jeep (Government),0,0,0,11.66702557,92.73598262
Andaman And Nicobar,2002,Jeep (Private),3,0,3,11.66702557,92.73598262
Andaman And Nicobar,2002,Car (Government),0,0,0,11.66702557,92.73598262
Andaman And Nicobar,2002,Car (Private),2,0,2,11.66702557,92.73598262
Andaman And Nicobar,2002,Three Wheeler,0,0,0,11.66702557,92.73598262
Andaman And Nicobar,2002,Two Wheeler,4,0,4,11.66702557,92.73598262
Andaman And Nicobar,2002,Bicycle,0,0,0,11.66702557,92.73598262
Andaman And Nicobar,2002,Pedestrian,0,0,0,11.66702557,92.73598262
Andaman And Nicobar,2002,Others (Please Specify),1,0,1,11.66702557,92.73598262
Andaman And Nicobar,2003,Truck/Lorry (Government),1,0,1,11.66702557,92.73598262
Andaman And Nicobar,2003,Truck/Lorry (Private),1,0,1,11.66702557,92.73598262
Andaman And Nicobar,2003,Bus (Government),0,0,0,11.66702557,92.73598262
Andaman And Nicobar,2003,Bus (Private),3,0,3,11.66702557,92.73598262
Andaman And Nicobar,2003,Tempo/Vans (Government),0,0,0,11.66702557,92.73598262
Andaman And Nicobar,2003,Tempo/Vans (Private),0,0,0,11.66702557,92.73598262
Andaman And Nicobar,2003,Jeep (Government),0,0,0,11.66702557,92.73598262
Andaman And Nicobar,2003,Jeep (Private),1,0,1,11.66702557,92.73598262
Andaman And Nicobar,2003,Car (Government),0,0,0,11.66702557,92.73598262
Andaman And Nicobar,2003,Car (Private),0,0,0,11.66702557,92.73598262
Andaman And Nicobar,2003,Three Wheeler,0,0,0,11.66702557,92.73598262
Andaman And Nicobar,2003,Two Wheeler,5,1,6,11.66702557,92.73598262
Andaman And Nicobar,2003,Bicycle,0,0,0,11.66702557,92.73598262
Andaman And Nicobar,2003,Pedestrian,0,0,0,11.66702557,92.73598262
Andaman And Nicobar,2003,Others (Please Specify),0,0,0,11.66702557,92.73598262
Andaman And Nicobar,2004,Truck/Lorry (Government),0,0,0,11.66702557,92.73598262
Andaman And Nicobar,2004,Truck/Lorry (Private),1,0,1,11.66702557,92.73598262
Andaman And Nicobar,2004,Bus (Government),0,0,0,11.66702557,92.73598262
Andaman And Nicobar,2004,Bus (Private),0,1,1,11.66702557,92.73598262
Andaman And Nicobar,2004,Tempo/Vans (Government),0,0,0,11.66702557,92.73598262
Andaman And Nicobar,2004,Tempo/Vans (Private),0,0,0,11.66702557,92.73598262
Andaman And Nicobar,2004,Jeep (Government),0,0,0,11.66702557,92.73598262
Andaman And Nicobar,2004,Jeep (Private),1,0,1,11.66702557,92.73598262
Andaman And Nicobar,2004,Car (Government),0,0,0,11.66702557,92.73598262
Andaman And Nicobar,2004,Car (Private),0,0,0,11.66702557,92.73598262
Andaman And Nicobar,2004,Three Wheeler,1,1,2,11.66702557,92.73598262
Andaman And Nicobar,2004,Two Wheeler,3,1,4,11.66702557,92.73598262
Andaman And Nicobar,2004,Bicycle,0,0,0,11.66702557,92.73598262
Andaman And Nicobar,2004,Pedestrian,6,0,6,11.66702557,92.73598262
Andaman And Nicobar,2004,Others (Please Specify),0,0,0,11.66702557,92.73598262
Andaman And Nicobar,2005,Truck/Lorry (Government),0,0,0,11.66702557,92.73598262
Andaman And Nicobar,2005,Truck/Lorry (Private),3,0,3,11.66702557,92.73598262
Andaman And Nicobar,2005,Bus (Government),4,3,7,11.66702557,92.73598262
Andaman And Nicobar,2005,Bus (Private),5,1,6,11.66702557,92.73598262
Andaman And Nicobar,2005,Tempo/Vans (Government),0,0,0,11.66702557,92.73598262
Andaman And Nicobar,2005,Tempo/Vans (Private),0,0,0,11.66702557,92.73598262
Andaman And Nicobar,2005,Jeep (Government),0,0,0,11.66702557,92.73598262
Andaman And Nicobar,2005,Jeep (Private),0,0,0,11.66702557,92.73598262
Andaman And Nicobar,2005,Car (Government),0,0,0,11.66702557,92.73598262
Andaman And Nicobar,2005,Car (Private),1,1,2,11.66702557,92.73598262
Andaman And Nicobar,2005,Three Wheeler,1,0,1,11.66702557,92.73598262
Andaman And Nicobar,2005,Two Wheeler,4,0,4,11.66702557,92.73598262
Andaman And Nicobar,2005,Bicycle,0,0,0,11.66702557,92.73598262
Andaman And Nicobar,2005,Pedestrian,0,0,0,11.66702557,92.73598262
Andaman And Nicobar,2005,Others (Please Specify),0,0,0,11.66702557,92.73598262
Andaman And Nicobar,2006,Truck/Lorry (Government),1,0,1,11.66702557,92.73598262
Andaman And Nicobar,2006,Truck/Lorry (Private),11,1,12,11.66702557,92.73598262
Andaman And Nicobar,2006,Bus (Government),0,0,0,11.66702557,92.73598262
Andaman And Nicobar,2006,Bus (Private),6,0,6,11.66702557,92.73598262
Andaman And Nicobar,2006,Tempo/Vans (Government),0,0,0,11.66702557,92.73598262
Andaman And Nicobar,2006,Tempo/Vans (Private),0,0,0,11.66702557,92.73598262
Andaman And Nicobar,2006,Jeep (Government),0,0,0,11.66702557,92.73598262
Andaman And Nicobar,2006,Jeep (Private),1,0,1,11.66702557,92.73598262
Andaman And Nicobar,2006,Car (Government),0,0,0,11.66702557,92.73598262
Andaman And Nicobar,2006,Car (Private),0,0,0,11.66702557,92.73598262
Andaman And Nicobar,2006,Three Wheeler,1,1,2,11.66702557,92.73598262
Andaman And Nicobar,2006,Two Wheeler,0,0,0,11.66702557,92.73598262
Andaman And Nicobar,2006,Bicycle,0,0,0,11.66702557,92.73598262
Andaman And Nicobar,2006,Pedestrian,0,0,0,11.66702557,92.73598262
Andaman And Nicobar,2006,Others (Please Specify),0,0,0,11.66702557,92.73598262
Andaman And Nicobar,2007,Truck/Lorry (Government),0,0,0,11.66702557,92.73598262
Andaman And Nicobar,2007,Truck/Lorry (Private),3,0,3,11.66702557,92.73598262
Andaman And Nicobar,2007,Bus (Government),0,0,0,11.66702557,92.73598262
Andaman And Nicobar,2007,Bus (Private),0,0,0,11.66702557,92.73598262
Andaman And Nicobar,2007,Tempo/Vans (Government),0,0,0,11.66702557,92.73598262
Andaman And Nicobar,2007,Tempo/Vans (Private),0,0,0,11.66702557,92.73598262
Andaman And Nicobar,2007,Jeep (Government),0,0,0,11.66702557,92.73598262
Andaman And Nicobar,2007,Jeep (Private),1,0,1,11.66702557,92.73598262
Andaman And Nicobar,2007,Car (Government),0,0,0,11.66702557,92.73598262
Andaman And Nicobar,2007,Car (Private),0,1,1,11.66702557,92.73598262
Andaman And Nicobar,2007,Three Wheeler,2,0,2,11.66702557,92.73598262
Andaman And Nicobar,2007,Two Wheeler,7,0,7,11.66702557,92.73598262
Andaman And Nicobar,2007,Bicycle,0,0,0,11.66702557,92.73598262
Andaman And Nicobar,2007,Pedestrian,7,2,9,11.66702557,92.73598262
Andaman And Nicobar,2007,Others (Please Specify),0,0,0,11.66702557,92.73598262
Andaman And Nicobar,2008,Truck/Lorry (Government),1,0,1,11.66702557,92.73598262
Andaman And Nicobar,2008,Truck/Lorry (Private),4,1,5,11.66702557,92.73598262
Andaman And Nicobar,2008,Bus (Government),0,0,0,11.66702557,92.73598262
Andaman And Nicobar,2008,Bus (Private),1,0,1,11.66702557,92.73598262
Andaman And Nicobar,2008,Tempo/Vans (Government),0,0,0,11.66702557,92.73598262
Andaman And Nicobar,2008,Tempo/Vans (Private),2,0,2,11.66702557,92.73598262
Andaman And Nicobar,2008,Jeep (Government),0,0,0,11.66702557,92.73598262
Andaman And Nicobar,2008,Jeep (Private),1,2,3,11.66702557,92.73598262
Andaman And Nicobar,2008,Car (Government),0,0,0,11.66702557,92.73598262
Andaman And Nicobar,2008,Car (Private),1,0,1,11.66702557,92.73598262
Andaman And Nicobar,2008,Three Wheeler,0,0,0,11.66702557,92.73598262
Andaman And Nicobar,2008,Two Wheeler,5,0,5,11.66702557,92.73598262
Andaman And Nicobar,2008,Bicycle,0,0,0,11.66702557,92.73598262
Andaman And Nicobar,2008,Pedestrian,3,0,3,11.66702557,92.73598262
Andaman And Nicobar,2008,Others (Please Specify),1,0,1,11.66702557,92.73598262
Andaman And Nicobar,2009,Truck/Lorry (Government),0,0,0,11.66702557,92.73598262
Andaman And Nicobar,2009,Truck/Lorry (Private),4,0,4,11.66702557,92.73598262
Andaman And Nicobar,2009,Bus (Government),1,0,1,11.66702557,92.73598262
Andaman And Nicobar,2009,Bus (Private),6,0,6,11.66702557,92.73598262
Andaman And Nicobar,2009,Tempo/Vans (Government),0,0,0,11.66702557,92.73598262
Andaman And Nicobar,2009,Tempo/Vans (Private),0,0,0,11.66702557,92.73598262
Andaman And Nicobar,2009,Jeep (Government),0,0,0,11.66702557,92.73598262
Andaman And Nicobar,2009,Jeep (Private),2,0,2,11.66702557,92.73598262
Andaman And Nicobar,2009,Car (Government),0,0,0,11.66702557,92.73598262
Andaman And Nicobar,2009,Car (Private),6,1,7,11.66702557,92.73598262
Andaman And Nicobar,2009,Three Wheeler,2,1,3,11.66702557,92.73598262
Andaman And Nicobar,2009,Two Wheeler,7,2,9,11.66702557,92.73598262
Andaman And Nicobar,2009,Bicycle,0,0,0,11.66702557,92.73598262
Andaman And Nicobar,2009,Pedestrian,0,0,0,11.66702557,92.73598262
Andaman And Nicobar,2009,Others (Please Specify),1,0,1,11.66702557,92.73598262
Andaman And Nicobar,2010,Truck/Lorry (Government),0,0,0,11.66702557,92.73598262
Andaman And Nicobar,2010,Truck/Lorry (Private),4,0,4,11.66702557,92.73598262
Andaman And Nicobar,2010,Bus (Government),0,0,0,11.66702557,92.73598262
Andaman And Nicobar,2010,Bus (Private),1,0,1,11.66702557,92.73598262
Andaman And Nicobar,2010,Tempo/Vans (Government),0,0,0,11.66702557,92.73598262
Andaman And Nicobar,2010,Tempo/Vans (Private),0,0,0,11.66702557,92.73598262
Andaman And Nicobar,2010,Jeep (Government),0,0,0,11.66702557,92.73598262
Andaman And Nicobar,2010,Jeep (Private),1,0,1,11.66702557,92.73598262
Andaman And Nicobar,2010,Car (Government),0,0,0,11.66702557,92.73598262
Andaman And Nicobar,2010,Car (Private),3,0,3,11.66702557,92.73598262
Andaman And Nicobar,2010,Three Wheeler,1,2,3,11.66702557,92.73598262
Andaman And Nicobar,2010,Two Wheeler,9,2,11,11.66702557,92.73598262
Andaman And Nicobar,2010,Bicycle,1,0,1,11.66702557,92.73598262
Andaman And Nicobar,2010,Pedestrian,1,2,3,11.66702557,92.73598262
Andaman And Nicobar,2010,Others (Please Specify),0,0,0,11.66702557,92.73598262
Andaman And Nicobar,2011,Truck/Lorry (Government),0,0,0,11.66702557,92.73598262
Andaman And Nicobar,2011,Truck/Lorry (Private),0,0,0,11.66702557,92.73598262
Andaman And Nicobar,2011,Bus (Government),0,0,0,11.66702557,92.73598262
Andaman And Nicobar,2011,Bus (Private),1,0,1,11.66702557,92.73598262
Andaman And Nicobar,2011,Tempo/Vans (Government),0,0,0,11.66702557,92.73598262
Andaman And Nicobar,2011,Tempo/Vans (Private),0,0,0,11.66702557,92.73598262
Andaman And Nicobar,2011,Jeep (Government),0,0,0,11.66702557,92.73598262
Andaman And Nicobar,2011,Jeep (Private),2,0,2,11.66702557,92.73598262
Andaman And Nicobar,2011,Car (Government),0,0,0,11.66702557,92.73598262
Andaman And Nicobar,2011,Car (Private),0,0,0,11.66702557,92.73598262
Andaman And Nicobar,2011,Three Wheeler,1,0,1,11.66702557,92.73598262
Andaman And Nicobar,2011,Two Wheeler,6,1,7,11.66702557,92.73598262
Andaman And Nicobar,2011,Bicycle,0,0,0,11.66702557,92.73598262
Andaman And Nicobar,2011,Pedestrian,5,1,6,11.66702557,92.73598262
Andaman And Nicobar,2011,Others (Please Specify),0,0,0,11.66702557,92.73598262
Andaman And Nicobar,2012,Truck/Lorry (Government),0,0,0,11.66702557,92.73598262
Andaman And Nicobar,2012,Truck/Lorry (Private),3,0,3,11.66702557,92.73598262
Andaman And Nicobar,2012,Bus (Government),0,0,0,11.66702557,92.73598262
Andaman And Nicobar,2012,Bus (Private),0,0,0,11.66702557,92.73598262
Andaman And Nicobar,2012,Tempo/Vans (Government),0,0,0,11.66702557,92.73598262
Andaman And Nicobar,2012,Tempo/Vans (Private),0,0,0,11.66702557,92.73598262
Andaman And Nicobar,2012,Jeep (Government),0,0,0,11.66702557,92.73598262
Andaman And Nicobar,2012,Jeep (Private),1,0,1,11.66702557,92.73598262
Andaman And Nicobar,2012,Car (Government),0,0,0,11.66702557,92.73598262
Andaman And Nicobar,2012,Car (Private),0,0,0,11.66702557,92.73598262
Andaman And Nicobar,2012,Three Wheeler,2,0,2,11.66702557,92.73598262
Andaman And Nicobar,2012,Two Wheeler,7,3,10,11.66702557,92.73598262
Andaman And Nicobar,2012,Bicycle,0,0,0,11.66702557,92.73598262
Andaman And Nicobar,2012,Pedestrian,5,4,9,11.66702557,92.73598262
Andaman And Nicobar,2012,Others (Please Specify),0,0,0,11.66702557,92.73598262
CHANDIGARH,2001,Truck/Lorry (Government),0,0,0,30.71999697,76.78000565
CHANDIGARH,2001,Truck/Lorry (Private),3,0,3,30.71999697,76.78000565
CHANDIGARH,2001,Bus (Government),0,0,0,30.71999697,76.78000565
CHANDIGARH,2001,Bus (Private),0,1,1,30.71999697,76.78000565
CHANDIGARH,2001,Tempo/Vans (Government),0,0,0,30.71999697,76.78000565
CHANDIGARH,2001,Tempo/Vans (Private),0,0,0,30.71999697,76.78000565
CHANDIGARH,2001,Jeep (Government),1,0,1,30.71999697,76.78000565
CHANDIGARH,2001,Jeep (Private),0,0,0,30.71999697,76.78000565
CHANDIGARH,2001,Car (Government),1,0,1,30.71999697,76.78000565
CHANDIGARH,2001,Car (Private),4,0,4,30.71999697,76.78000565
CHANDIGARH,2001,Three Wheeler,1,0,1,30.71999697,76.78000565
CHANDIGARH,2001,Two Wheeler,38,11,49,30.71999697,76.78000565
CHANDIGARH,2001,Bicycle,24,4,28,30.71999697,76.78000565
CHANDIGARH,2001,Pedestrian,15,6,21,30.71999697,76.78000565
CHANDIGARH,2001,Others (Please Specify),7,2,9,30.71999697,76.78000565
CHANDIGARH,2002,Truck/Lorry (Government),0,0,0,30.71999697,76.78000565
CHANDIGARH,2002,Truck/Lorry (Private),0,0,0,30.71999697,76.78000565
CHANDIGARH,2002,Bus (Government),0,0,0,30.71999697,76.78000565
CHANDIGARH,2002,Bus (Private),0,0,0,30.71999697,76.78000565
CHANDIGARH,2002,Tempo/Vans (Government),0,0,0,30.71999697,76.78000565
CHANDIGARH,2002,Tempo/Vans (Private),0,0,0,30.71999697,76.78000565
CHANDIGARH,2002,Jeep (Government),0,0,0,30.71999697,76.78000565
CHANDIGARH,2002,Jeep (Private),2,0,2,30.71999697,76.78000565
CHANDIGARH,2002,Car (Government),0,0,0,30.71999697,76.78000565
CHANDIGARH,2002,Car (Private),9,4,13,30.71999697,76.78000565
CHANDIGARH,2002,Three Wheeler,4,0,4,30.71999697,76.78000565
CHANDIGARH,2002,Two Wheeler,21,5,26,30.71999697,76.78000565
CHANDIGARH,2002,Bicycle,18,1,19,30.71999697,76.78000565
CHANDIGARH,2002,Pedestrian,33,6,39,30.71999697,76.78000565
CHANDIGARH,2002,Others (Please Specify),4,1,5,30.71999697,76.78000565
CHANDIGARH,2003,Truck/Lorry (Government),0,0,0,30.71999697,76.78000565
CHANDIGARH,2003,Truck/Lorry (Private),0,0,0,30.71999697,76.78000565
CHANDIGARH,2003,Bus (Government),0,1,1,30.71999697,76.78000565
CHANDIGARH,2003,Bus (Private),0,0,0,30.71999697,76.78000565
CHANDIGARH,2003,Tempo/Vans (Government),0,0,0,30.71999697,76.78000565
CHANDIGARH,2003,Tempo/Vans (Private),0,0,0,30.71999697,76.78000565
CHANDIGARH,2003,Jeep (Government),0,0,0,30.71999697,76.78000565
CHANDIGARH,2003,Jeep (Private),0,0,0,30.71999697,76.78000565
CHANDIGARH,2003,Car (Government),0,0,0,30.71999697,76.78000565
CHANDIGARH,2003,Car (Private),1,3,4,30.71999697,76.78000565
CHANDIGARH,2003,Three Wheeler,4,0,4,30.71999697,76.78000565
CHANDIGARH,2003,Two Wheeler,48,7,55,30.71999697,76.78000565
CHANDIGARH,2003,Bicycle,24,2,26,30.71999697,76.78000565
CHANDIGARH,2003,Pedestrian,23,9,32,30.71999697,76.78000565
CHANDIGARH,2003,Others (Please Specify),7,5,12,30.71999697,76.78000565
CHANDIGARH,2004,Truck/Lorry (Government),0,0,0,30.71999697,76.78000565
CHANDIGARH,2004,Truck/Lorry (Private),3,0,3,30.71999697,76.78000565
CHANDIGARH,2004,Bus (Government),0,1,1,30.71999697,76.78000565
CHANDIGARH,2004,Bus (Private),0,0,0,30.71999697,76.78000565
CHANDIGARH,2004,Tempo/Vans (Government),0,0,0,30.71999697,76.78000565
CHANDIGARH,2004,Tempo/Vans (Private),0,0,0,30.71999697,76.78000565
CHANDIGARH,2004,Jeep (Government),0,0,0,30.71999697,76.78000565
CHANDIGARH,2004,Jeep (Private),0,0,0,30.71999697,76.78000565
CHANDIGARH,2004,Car (Government),0,0,0,30.71999697,76.78000565
CHANDIGARH,2004,Car (Private),1,0,1,30.71999697,76.78000565
CHANDIGARH,2004,Three Wheeler,2,1,3,30.71999697,76.78000565
CHANDIGARH,2004,Two Wheeler,69,13,82,30.71999697,76.78000565
CHANDIGARH,2004,Bicycle,2,0,2,30.71999697,76.78000565
CHANDIGARH,2004,Pedestrian,20,4,24,30.71999697,76.78000565
CHANDIGARH,2004,Others (Please Specify),26,5,31,30.71999697,76.78000565
CHANDIGARH,2005,Truck/Lorry (Government),0,0,0,30.71999697,76.78000565
CHANDIGARH,2005,Truck/Lorry (Private),0,0,0,30.71999697,76.78000565
CHANDIGARH,2005,Bus (Government),6,1,7,30.71999697,76.78000565
CHANDIGARH,2005,Bus (Private),0,0,0,30.71999697,76.78000565
CHANDIGARH,2005,Tempo/Vans (Government),0,0,0,30.71999697,76.78000565
CHANDIGARH,2005,Tempo/Vans (Private),0,0,0,30.71999697,76.78000565
CHANDIGARH,2005,Jeep (Government),1,0,1,30.71999697,76.78000565
CHANDIGARH,2005,Jeep (Private),0,0,0,30.71999697,76.78000565
CHANDIGARH,2005,Car (Government),0,0,0,30.71999697,76.78000565
CHANDIGARH,2005,Car (Private),2,2,4,30.71999697,76.78000565
CHANDIGARH,2005,Three Wheeler,2,0,2,30.71999697,76.78000565
CHANDIGARH,2005,Two Wheeler,49,6,55,30.71999697,76.78000565
CHANDIGARH,2005,Bicycle,20,3,23,30.71999697,76.78000565
CHANDIGARH,2005,Pedestrian,29,11,40,30.71999697,76.78000565
CHANDIGARH,2005,Others (Please Specify),2,0,2,30.71999697,76.78000565
CHANDIGARH,2006,Truck/Lorry (Government),0,0,0,30.71999697,76.78000565
CHANDIGARH,2006,Truck/Lorry (Private),0,0,0,30.71999697,76.78000565
CHANDIGARH,2006,Bus (Government),0,0,0,30.71999697,76.78000565
CHANDIGARH,2006,Bus (Private),0,0,0,30.71999697,76.78000565
CHANDIGARH,2006,Tempo/Vans (Government),0,0,0,30.71999697,76.78000565
CHANDIGARH,2006,Tempo/Vans (Private),0,0,0,30.71999697,76.78000565
CHANDIGARH,2006,Jeep (Government),0,0,0,30.71999697,76.78000565
CHANDIGARH,2006,Jeep (Private),0,0,0,30.71999697,76.78000565
CHANDIGARH,2006,Car (Government),0,0,0,30.71999697,76.78000565
CHANDIGARH,2006,Car (Private),4,0,4,30.71999697,76.78000565
CHANDIGARH,2006,Three Wheeler,9,0,9,30.71999697,76.78000565
CHANDIGARH,2006,Two Wheeler,46,11,57,30.71999697,76.78000565
CHANDIGARH,2006,Bicycle,27,1,28,30.71999697,76.78000565
CHANDIGARH,2006,Pedestrian,30,9,39,30.71999697,76.78000565
CHANDIGARH,2006,Others (Please Specify),4,0,4,30.71999697,76.78000565
CHANDIGARH,2007,Truck/Lorry (Government),0,0,0,30.71999697,76.78000565
CHANDIGARH,2007,Truck/Lorry (Private),0,0,0,30.71999697,76.78000565
CHANDIGARH,2007,Bus (Government),0,1,1,30.71999697,76.78000565
CHANDIGARH,2007,Bus (Private),0,0,0,30.71999697,76.78000565
CHANDIGARH,2007,Tempo/Vans (Government),0,0,0,30.71999697,76.78000565
CHANDIGARH,2007,Tempo/Vans (Private),2,0,2,30.71999697,76.78000565
CHANDIGARH,2007,Jeep (Government),0,0,0,30.71999697,76.78000565
CHANDIGARH,2007,Jeep (Private),0,0,0,30.71999697,76.78000565
CHANDIGARH,2007,Car (Government),0,0,0,30.71999697,76.78000565
CHANDIGARH,2007,Car (Private),7,1,8,30.71999697,76.78000565
CHANDIGARH,2007,Three Wheeler,1,1,2,30.71999697,76.78000565
CHANDIGARH,2007,Two Wheeler,63,6,69,30.71999697,76.78000565
CHANDIGARH,2007,Bicycle,21,3,24,30.71999697,76.78000565
CHANDIGARH,2007,Pedestrian,31,9,40,30.71999697,76.78000565
CHANDIGARH,2007,Others (Please Specify),5,0,5,30.71999697,76.78000565
CHANDIGARH,2008,Truck/Lorry (Government),0,0,0,30.71999697,76.78000565
CHANDIGARH,2008,Truck/Lorry (Private),0,0,0,30.71999697,76.78000565
CHANDIGARH,2008,Bus (Government),0,0,0,30.71999697,76.78000565
CHANDIGARH,2008,Bus (Private),1,1,2,30.71999697,76.78000565
CHANDIGARH,2008,Tempo/Vans (Government),0,0,0,30.71999697,76.78000565
CHANDIGARH,2008,Tempo/Vans (Private),0,0,0,30.71999697,76.78000565
CHANDIGARH,2008,Jeep (Government),0,0,0,30.71999697,76.78000565
CHANDIGARH,2008,Jeep (Private),0,0,0,30.71999697,76.78000565
CHANDIGARH,2008,Car (Government),0,0,0,30.71999697,76.78000565
CHANDIGARH,2008,Car (Private),5,0,5,30.71999697,76.78000565
CHANDIGARH,2008,Three Wheeler,5,0,5,30.71999697,76.78000565
CHANDIGARH,2008,Two Wheeler,55,8,63,30.71999697,76.78000565
CHANDIGARH,2008,Bicycle,21,2,23,30.71999697,76.78000565
CHANDIGARH,2008,Pedestrian,31,12,43,30.71999697,76.78000565
CHANDIGARH,2008,Others (Please Specify),3,2,5,30.71999697,76.78000565
CHANDIGARH,2009,Truck/Lorry (Government),0,0,0,30.71999697,76.78000565
CHANDIGARH,2009,Truck/Lorry (Private),0,0,0,30.71999697,76.78000565
CHANDIGARH,2009,Bus (Government),2,1,3,30.71999697,76.78000565
CHANDIGARH,2009,Bus (Private),1,0,1,30.71999697,76.78000565
CHANDIGARH,2009,Tempo/Vans (Government),0,0,0,30.71999697,76.78000565
CHANDIGARH,2009,Tempo/Vans (Private),0,0,0,30.71999697,76.78000565
CHANDIGARH,2009,Jeep (Government),0,0,0,30.71999697,76.78000565
CHANDIGARH,2009,Jeep (Private),0,0,0,30.71999697,76.78000565
CHANDIGARH,2009,Car (Government),0,0,0,30.71999697,76.78000565
CHANDIGARH,2009,Car (Private),3,0,3,30.71999697,76.78000565
CHANDIGARH,2009,Three Wheeler,3,1,4,30.71999697,76.78000565
CHANDIGARH,2009,Two Wheeler,64,7,71,30.71999697,76.78000565
CHANDIGARH,2009,Bicycle,25,0,25,30.71999697,76.78000565
CHANDIGARH,2009,Pedestrian,46,12,58,30.71999697,76.78000565
CHANDIGARH,2009,Others (Please Specify),4,2,6,30.71999697,76.78000565
CHANDIGARH,2010,Truck/Lorry (Government),0,0,0,30.71999697,76.78000565
CHANDIGARH,2010,Truck/Lorry (Private),0,0,0,30.71999697,76.78000565
CHANDIGARH,2010,Bus (Government),0,0,0,30.71999697,76.78000565
CHANDIGARH,2010,Bus (Private),0,0,0,30.71999697,76.78000565
CHANDIGARH,2010,Tempo/Vans (Government),0,0,0,30.71999697,76.78000565
CHANDIGARH,2010,Tempo/Vans (Private),0,0,0,30.71999697,76.78000565
CHANDIGARH,2010,Jeep (Government),0,0,0,30.71999697,76.78000565
CHANDIGARH,2010,Jeep (Private),0,0,0,30.71999697,76.78000565
CHANDIGARH,2010,Car (Government),0,0,0,30.71999697,76.78000565
CHANDIGARH,2010,Car (Private),7,0,7,30.71999697,76.78000565
CHANDIGARH,2010,Three Wheeler,1,1,2,30.71999697,76.78000565
CHANDIGARH,2010,Two Wheeler,40,8,48,30.71999697,76.78000565
CHANDIGARH,2010,Bicycle,23,2,25,30.71999697,76.78000565
CHANDIGARH,2010,Pedestrian,40,12,52,30.71999697,76.78000565
CHANDIGARH,2010,Others (Please Specify),3,1,4,30.71999697,76.78000565
CHANDIGARH,2011,Truck/Lorry (Government),0,0,0,30.71999697,76.78000565
CHANDIGARH,2011,Truck/Lorry (Private),0,0,0,30.71999697,76.78000565
CHANDIGARH,2011,Bus (Government),0,0,0,30.71999697,76.78000565
CHANDIGARH,2011,Bus (Private),0,0,0,30.71999697,76.78000565
CHANDIGARH,2011,Tempo/Vans (Government),0,0,0,30.71999697,76.78000565
CHANDIGARH,2011,Tempo/Vans (Private),0,0,0,30.71999697,76.78000565
CHANDIGARH,2011,Jeep (Government),0,0,0,30.71999697,76.78000565
CHANDIGARH,2011,Jeep (Private),0,0,0,30.71999697,76.78000565
CHANDIGARH,2011,Car (Government),0,0,0,30.71999697,76.78000565
CHANDIGARH,2011,Car (Private),6,2,8,30.71999697,76.78000565
CHANDIGARH,2011,Three Wheeler,2,0,2,30.71999697,76.78000565
CHANDIGARH,2011,Two Wheeler,44,6,50,30.71999697,76.78000565
CHANDIGARH,2011,Bicycle,20,2,22,30.71999697,76.78000565
CHANDIGARH,2011,Pedestrian,35,12,47,30.71999697,76.78000565
CHANDIGARH,2011,Others (Please Specify),7,0,7,30.71999697,76.78000565
CHANDIGARH,2012,Truck/Lorry (Government),0,0,0,30.71999697,76.78000565
CHANDIGARH,2012,Truck/Lorry (Private),0,0,0,30.71999697,76.78000565
CHANDIGARH,2012,Bus (Government),0,0,0,30.71999697,76.78000565
CHANDIGARH,2012,Bus (Private),0,0,0,30.71999697,76.78000565
CHANDIGARH,2012,Tempo/Vans (Government),0,0,0,30.71999697,76.78000565
CHANDIGARH,2012,Tempo/Vans (Private),0,1,1,30.71999697,76.78000565
CHANDIGARH,2012,Jeep (Government),0,0,0,30.71999697,76.78000565
CHANDIGARH,2012,Jeep (Private),1,0,1,30.71999697,76.78000565
CHANDIGARH,2012,Car (Government),0,0,0,30.71999697,76.78000565
CHANDIGARH,2012,Car (Private),3,2,5,30.71999697,76.78000565
CHANDIGARH,2012,Three Wheeler,2,3,5,30.71999697,76.78000565
CHANDIGARH,2012,Two Wheeler,42,2,44,30.71999697,76.78000565
CHANDIGARH,2012,Bicycle,22,0,22,30.71999697,76.78000565
CHANDIGARH,2012,Pedestrian,26,6,32,30.71999697,76.78000565
CHANDIGARH,2012,Others (Please Specify),3,1,4,30.71999697,76.78000565
Dadra And Nagar Haveli,2001,Truck/Lorry (Government),0,0,0,20.26657819,73.0166178
Dadra And Nagar Haveli,2001,Truck/Lorry (Private),5,2,7,20.26657819,73.0166178
Dadra And Nagar Haveli,2001,Bus (Government),1,0,1,20.26657819,73.0166178
Dadra And Nagar Haveli,2001,Bus (Private),0,0,0,20.26657819,73.0166178
Dadra And Nagar Haveli,2001,Tempo/Vans (Government),0,0,0,20.26657819,73.0166178
Dadra And Nagar Haveli,2001,Tempo/Vans (Private),2,1,3,20.26657819,73.0166178
Dadra And Nagar Haveli,2001,Jeep (Government),0,0,0,20.26657819,73.0166178
Dadra And Nagar Haveli,2001,Jeep (Private),0,0,0,20.26657819,73.0166178
Dadra And Nagar Haveli,2001,Car (Government),0,0,0,20.26657819,73.0166178
Dadra And Nagar Haveli,2001,Car (Private),1,0,1,20.26657819,73.0166178
Dadra And Nagar Haveli,2001,Three Wheeler,1,2,3,20.26657819,73.0166178
Dadra And Nagar Haveli,2001,Two Wheeler,6,0,6,20.26657819,73.0166178
Dadra And Nagar Haveli,2001,Bicycle,4,0,4,20.26657819,73.0166178
Dadra And Nagar Haveli,2001,Pedestrian,6,5,11,20.26657819,73.0166178
Dadra And Nagar Haveli,2001,Others (Please Specify),1,0,1,20.26657819,73.0166178
Dadra And Nagar Haveli,2002,Truck/Lorry (Government),0,0,0,20.26657819,73.0166178
Dadra And Nagar Haveli,2002,Truck/Lorry (Private),1,0,1,20.26657819,73.0166178
Dadra And Nagar Haveli,2002,Bus (Government),0,0,0,20.26657819,73.0166178
Dadra And Nagar Haveli,2002,Bus (Private),1,0,1,20.26657819,73.0166178
Dadra And Nagar Haveli,2002,Tempo/Vans (Government),0,0,0,20.26657819,73.0166178
Dadra And Nagar Haveli,2002,Tempo/Vans (Private),0,0,0,20.26657819,73.0166178
Dadra And Nagar Haveli,2002,Jeep (Government),0,0,0,20.26657819,73.0166178
Dadra And Nagar Haveli,2002,Jeep (Private),0,0,0,20.26657819,73.0166178
Dadra And Nagar Haveli,2002,Car (Government),0,0,0,20.26657819,73.0166178
Dadra And Nagar Haveli,2002,Car (Private),2,0,2,20.26657819,73.0166178
Dadra And Nagar Haveli,2002,Three Wheeler,3,1,4,20.26657819,73.0166178
Dadra And Nagar Haveli,2002,Two Wheeler,7,0,7,20.26657819,73.0166178
Dadra And Nagar Haveli,2002,Bicycle,2,0,2,20.26657819,73.0166178
Dadra And Nagar Haveli,2002,Pedestrian,8,4,12,20.26657819,73.0166178
Dadra And Nagar Haveli,2002,Others (Please Specify),3,0,3,20.26657819,73.0166178
Dadra And Nagar Haveli,2003,Truck/Lorry (Government),0,0,0,20.26657819,73.0166178
Dadra And Nagar Haveli,2003,Truck/Lorry (Private),2,0,2,20.26657819,73.0166178
Dadra And Nagar Haveli,2003,Bus (Government),2,0,2,20.26657819,73.0166178
Dadra And Nagar Haveli,2003,Bus (Private),1,0,1,20.26657819,73.0166178
Dadra And Nagar Haveli,2003,Tempo/Vans (Government),0,0,0,20.26657819,73.0166178
Dadra And Nagar Haveli,2003,Tempo/Vans (Private),4,1,5,20.26657819,73.0166178
Dadra And Nagar Haveli,2003,Jeep (Government),0,0,0,20.26657819,73.0166178
Dadra And Nagar Haveli,2003,Jeep (Private),4,0,4,20.26657819,73.0166178
Dadra And Nagar Haveli,2003,Car (Government),0,0,0,20.26657819,73.0166178
Dadra And Nagar Haveli,2003,Car (Private),2,0,2,20.26657819,73.0166178
Dadra And Nagar Haveli,2003,Three Wheeler,3,0,3,20.26657819,73.0166178
Dadra And Nagar Haveli,2003,Two Wheeler,4,0,4,20.26657819,73.0166178
Dadra And Nagar Haveli,2003,Bicycle,3,0,3,20.26657819,73.0166178
Dadra And Nagar Haveli,2003,Pedestrian,3,2,5,20.26657819,73.0166178
Dadra And Nagar Haveli,2003,Others (Please Specify),3,0,3,20.26657819,73.0166178
Dadra And Nagar Haveli,2004,Truck/Lorry (Government),0,0,0,20.26657819,73.0166178
Dadra And Nagar Haveli,2004,Truck/Lorry (Private),3,1,4,20.26657819,73.0166178
Dadra And Nagar Haveli,2004,Bus (Government),0,0,0,20.26657819,73.0166178
Dadra And Nagar Haveli,2004,Bus (Private),0,3,3,20.26657819,73.0166178
Dadra And Nagar Haveli,2004,Tempo/Vans (Government),0,0,0,20.26657819,73.0166178
Dadra And Nagar Haveli,2004,Tempo/Vans (Private),4,0,4,20.26657819,73.0166178
Dadra And Nagar Haveli,2004,Jeep (Government),0,0,0,20.26657819,73.0166178
Dadra And Nagar Haveli,2004,Jeep (Private),0,0,0,20.26657819,73.0166178
Dadra And Nagar Haveli,2004,Car (Government),0,0,0,20.26657819,73.0166178
Dadra And Nagar Haveli,2004,Car (Private),0,0,0,20.26657819,73.0166178
Dadra And Nagar Haveli,2004,Three Wheeler,3,1,4,20.26657819,73.0166178
Dadra And Nagar Haveli,2004,Two Wheeler,11,1,12,20.26657819,73.0166178
Dadra And Nagar Haveli,2004,Bicycle,5,1,6,20.26657819,73.0166178
Dadra And Nagar Haveli,2004,Pedestrian,11,1,12,20.26657819,73.0166178
Dadra And Nagar Haveli,2004,Others (Please Specify),6,3,9,20.26657819,73.0166178
Dadra And Nagar Haveli,2005,Truck/Lorry (Government),0,0,0,20.26657819,73.0166178
Dadra And Nagar Haveli,2005,Truck/Lorry (Private),18,2,20,20.26657819,73.0166178
Dadra And Nagar Haveli,2005,Bus (Government),0,0,0,20.26657819,73.0166178
Dadra And Nagar Haveli,2005,Bus (Private),0,0,0,20.26657819,73.0166178
Dadra And Nagar Haveli,2005,Tempo/Vans (Government),0,0,0,20.26657819,73.0166178
Dadra And Nagar Haveli,2005,Tempo/Vans (Private),3,0,3,20.26657819,73.0166178
Dadra And Nagar Haveli,2005,Jeep (Government),0,0,0,20.26657819,73.0166178
Dadra And Nagar Haveli,2005,Jeep (Private),5,1,6,20.26657819,73.0166178
Dadra And Nagar Haveli,2005,Car (Government),0,0,0,20.26657819,73.0166178
Dadra And Nagar Haveli,2005,Car (Private),4,0,4,20.26657819,73.0166178
Dadra And Nagar Haveli,2005,Three Wheeler,2,0,2,20.26657819,73.0166178
Dadra And Nagar Haveli,2005,Two Wheeler,10,3,13,20.26657819,73.0166178
Dadra And Nagar Haveli,2005,Bicycle,0,0,0,20.26657819,73.0166178
Dadra And Nagar Haveli,2005,Pedestrian,0,0,0,20.26657819,73.0166178
Dadra And Nagar Haveli,2005,Others (Please Specify),7,0,7,20.26657819,73.0166178
Dadra And Nagar Haveli,2006,Truck/Lorry (Government),0,0,0,20.26657819,73.0166178
Dadra And Nagar Haveli,2006,Truck/Lorry (Private),16,1,17,20.26657819,73.0166178
Dadra And Nagar Haveli,2006,Bus (Government),3,0,3,20.26657819,73.0166178
Dadra And Nagar Haveli,2006,Bus (Private),4,0,4,20.26657819,73.0166178
Dadra And Nagar Haveli,2006,Tempo/Vans (Government),0,0,0,20.26657819,73.0166178
Dadra And Nagar Haveli,2006,Tempo/Vans (Private),5,0,5,20.26657819,73.0166178
Dadra And Nagar Haveli,2006,Jeep (Government),0,0,0,20.26657819,73.0166178
Dadra And Nagar Haveli,2006,Jeep (Private),0,0,0,20.26657819,73.0166178
Dadra And Nagar Haveli,2006,Car (Government),0,0,0,20.26657819,73.0166178
Dadra And Nagar Haveli,2006,Car (Private),0,0,0,20.26657819,73.0166178
Dadra And Nagar Haveli,2006,Three Wheeler,1,1,2,20.26657819,73.0166178
Dadra And Nagar Haveli,2006,Two Wheeler,8,1,9,20.26657819,73.0166178
Dadra And Nagar Haveli,2006,Bicycle,0,0,0,20.26657819,73.0166178
Dadra And Nagar Haveli,2006,Pedestrian,0,0,0,20.26657819,73.0166178
Dadra And Nagar Haveli,2006,Others (Please Specify),4,1,5,20.26657819,73.0166178
Dadra And Nagar Haveli,2007,Truck/Lorry (Government),0,0,0,20.26657819,73.0166178
Dadra And Nagar Haveli,2007,Truck/Lorry (Private),16,0,16,20.26657819,73.0166178
Dadra And Nagar Haveli,2007,Bus (Government),0,0,0,20.26657819,73.0166178
Dadra And Nagar Haveli,2007,Bus (Private),3,0,3,20.26657819,73.0166178
Dadra And Nagar Haveli,2007,Tempo/Vans (Government),0,0,0,20.26657819,73.0166178
Dadra And Nagar Haveli,2007,Tempo/Vans (Private),11,0,11,20.26657819,73.0166178
Dadra And Nagar Haveli,2007,Jeep (Government),0,0,0,20.26657819,73.0166178
Dadra And Nagar Haveli,2007,Jeep (Private),1,0,1,20.26657819,73.0166178
Dadra And Nagar Haveli,2007,Car (Government),0,0,0,20.26657819,73.0166178
Dadra And Nagar Haveli,2007,Car (Private),2,0,2,20.26657819,73.0166178
Dadra And Nagar Haveli,2007,Three Wheeler,3,3,6,20.26657819,73.0166178
Dadra And Nagar Haveli,2007,Two Wheeler,19,0,19,20.26657819,73.0166178
Dadra And Nagar Haveli,2007,Bicycle,0,0,0,20.26657819,73.0166178
Dadra And Nagar Haveli,2007,Pedestrian,0,0,0,20.26657819,73.0166178
Dadra And Nagar Haveli,2007,Others (Please Specify),8,0,8,20.26657819,73.0166178
Dadra And Nagar Haveli,2008,Truck/Lorry (Government),0,1,1,20.26657819,73.0166178
Dadra And Nagar Haveli,2008,Truck/Lorry (Private),9,1,10,20.26657819,73.0166178
Dadra And Nagar Haveli,2008,Bus (Government),0,0,0,20.26657819,73.0166178
Dadra And Nagar Haveli,2008,Bus (Private),4,0,4,20.26657819,73.0166178
Dadra And Nagar Haveli,2008,Tempo/Vans (Government),0,1,1,20.26657819,73.0166178
Dadra And Nagar Haveli,2008,Tempo/Vans (Private),10,0,10,20.26657819,73.0166178
Dadra And Nagar Haveli,2008,Jeep (Government),0,0,0,20.26657819,73.0166178
Dadra And Nagar Haveli,2008,Jeep (Private),0,0,0,20.26657819,73.0166178
Dadra And Nagar Haveli,2008,Car (Government),0,0,0,20.26657819,73.0166178
Dadra And Nagar Haveli,2008,Car (Private),2,0,2,20.26657819,73.0166178
Dadra And Nagar Haveli,2008,Three Wheeler,3,0,3,20.26657819,73.0166178
Dadra And Nagar Haveli,2008,Two Wheeler,24,1,25,20.26657819,73.0166178
Dadra And Nagar Haveli,2008,Bicycle,0,0,0,20.26657819,73.0166178
Dadra And Nagar Haveli,2008,Pedestrian,4,0,4,20.26657819,73.0166178
Dadra And Nagar Haveli,2008,Others (Please Specify),5,0,5,20.26657819,73.0166178
Dadra And Nagar Haveli,2009,Truck/Lorry (Government),0,0,0,20.26657819,73.0166178
Dadra And Nagar Haveli,2009,Truck/Lorry (Private),0,0,0,20.26657819,73.0166178
Dadra And Nagar Haveli,2009,Bus (Government),0,0,0,20.26657819,73.0166178
Dadra And Nagar Haveli,2009,Bus (Private),0,0,0,20.26657819,73.0166178
Dadra And Nagar Haveli,2009,Tempo/Vans (Government),0,0,0,20.26657819,73.0166178
Dadra And Nagar Haveli,2009,Tempo/Vans (Private),0,0,0,20.26657819,73.0166178
Dadra And Nagar Haveli,2009,Jeep (Government),0,0,0,20.26657819,73.0166178
Dadra And Nagar Haveli,2009,Jeep (Private),0,0,0,20.26657819,73.0166178
Dadra And Nagar Haveli,2009,Car (Government),0,0,0,20.26657819,73.0166178
Dadra And Nagar Haveli,2009,Car (Private),4,0,4,20.26657819,73.0166178
Dadra And Nagar Haveli,2009,Three Wheeler,2,0,2,20.26657819,73.0166178
Dadra And Nagar Haveli,2009,Two Wheeler,18,4,22,20.26657819,73.0166178
Dadra And Nagar Haveli,2009,Bicycle,5,0,5,20.26657819,73.0166178
Dadra And Nagar Haveli,2009,Pedestrian,10,1,11,20.26657819,73.0166178
Dadra And Nagar Haveli,2009,Others (Please Specify),1,0,1,20.26657819,73.0166178
Dadra And Nagar Haveli,2010,Truck/Lorry (Government),0,0,0,20.26657819,73.0166178
Dadra And Nagar Haveli,2010,Truck/Lorry (Private),1,0,1,20.26657819,73.0166178
Dadra And Nagar Haveli,2010,Bus (Government),0,0,0,20.26657819,73.0166178
Dadra And Nagar Haveli,2010,Bus (Private),0,1,1,20.26657819,73.0166178
Dadra And Nagar Haveli,2010,Tempo/Vans (Government),0,0,0,20.26657819,73.0166178
Dadra And Nagar Haveli,2010,Tempo/Vans (Private),0,0,0,20.26657819,73.0166178
Dadra And Nagar Haveli,2010,Jeep (Government),0,0,0,20.26657819,73.0166178
Dadra And Nagar Haveli,2010,Jeep (Private),2,0,2,20.26657819,73.0166178
Dadra And Nagar Haveli,2010,Car (Government),0,0,0,20.26657819,73.0166178
Dadra And Nagar Haveli,2010,Car (Private),1,1,2,20.26657819,73.0166178
Dadra And Nagar Haveli,2010,Three Wheeler,2,0,2,20.26657819,73.0166178
Dadra And Nagar Haveli,2010,Two Wheeler,31,3,34,20.26657819,73.0166178
Dadra And Nagar Haveli,2010,Bicycle,2,0,2,20.26657819,73.0166178
Dadra And Nagar Haveli,2010,Pedestrian,10,1,11,20.26657819,73.0166178
Dadra And Nagar Haveli,2010,Others (Please Specify),6,1,7,20.26657819,73.0166178
Dadra And Nagar Haveli,2011,Truck/Lorry (Government),0,0,0,20.26657819,73.0166178
Dadra And Nagar Haveli,2011,Truck/Lorry (Private),2,0,2,20.26657819,73.0166178
Dadra And Nagar Haveli,2011,Bus (Government),0,0,0,20.26657819,73.0166178
Dadra And Nagar Haveli,2011,Bus (Private),0,0,0,20.26657819,73.0166178
Dadra And Nagar Haveli,2011,Tempo/Vans (Government),0,0,0,20.26657819,73.0166178
Dadra And Nagar Haveli,2011,Tempo/Vans (Private),0,0,0,20.26657819,73.0166178
Dadra And Nagar Haveli,2011,Jeep (Government),0,0,0,20.26657819,73.0166178
Dadra And Nagar Haveli,2011,Jeep (Private),0,0,0,20.26657819,73.0166178
Dadra And Nagar Haveli,2011,Car (Government),0,0,0,20.26657819,73.0166178
Dadra And Nagar Haveli,2011,Car (Private),4,0,4,20.26657819,73.0166178
Dadra And Nagar Haveli,2011,Three Wheeler,2,1,3,20.26657819,73.0166178
Dadra And Nagar Haveli,2011,Two Wheeler,23,5,28,20.26657819,73.0166178
Dadra And Nagar Haveli,2011,Bicycle,2,1,3,20.26657819,73.0166178
Dadra And Nagar Haveli,2011,Pedestrian,14,2,16,20.26657819,73.0166178
Dadra And Nagar Haveli,2011,Others (Please Specify),7,0,7,20.26657819,73.0166178
Dadra And Nagar Haveli,2012,Truck/Lorry (Government),0,0,0,20.26657819,73.0166178
Dadra And Nagar Haveli,2012,Truck/Lorry (Private),7,2,9,20.26657819,73.0166178
Dadra And Nagar Haveli,2012,Bus (Government),1,0,1,20.26657819,73.0166178
Dadra And Nagar Haveli,2012,Bus (Private),0,2,2,20.26657819,73.0166178
Dadra And Nagar Haveli,2012,Tempo/Vans (Government),0,1,1,20.26657819,73.0166178
Dadra And Nagar Haveli,2012,Tempo/Vans (Private),6,1,7,20.26657819,73.0166178
Dadra And Nagar Haveli,2012,Jeep (Government),0,0,0,20.26657819,73.0166178
Dadra And Nagar Haveli,2012,Jeep (Private),0,0,0,20.26657819,73.0166178
Dadra And Nagar Haveli,2012,Car (Government),0,0,0,20.26657819,73.0166178
Dadra And Nagar Haveli,2012,Car (Private),5,1,6,20.26657819,73.0166178
Dadra And Nagar Haveli,2012,Three Wheeler,0,0,0,20.26657819,73.0166178
Dadra And Nagar Haveli,2012,Two Wheeler,15,2,17,20.26657819,73.0166178
Dadra And Nagar Haveli,2012,Bicycle,0,0,0,20.26657819,73.0166178
Dadra And Nagar Haveli,2012,Pedestrian,0,0,0,20.26657819,73.0166178
Dadra And Nagar Haveli,2012,Others (Please Specify),9,1,10,20.26657819,73.0166178
DAMAN & DIU,2001,Truck/Lorry (Government),0,0,0,20.4283,72.8397
DAMAN & DIU,2001,Truck/Lorry (Private),0,0,0,20.4283,72.8397
DAMAN & DIU,2001,Bus (Government),0,0,0,20.4283,72.8397
DAMAN & DIU,2001,Bus (Private),0,0,0,20.4283,72.8397
DAMAN & DIU,2001,Tempo/Vans (Government),0,0,0,20.4283,72.8397
DAMAN & DIU,2001,Tempo/Vans (Private),0,0,0,20.4283,72.8397
DAMAN & DIU,2001,Jeep (Government),0,0,0,20.4283,72.8397
DAMAN & DIU,2001,Jeep (Private),0,0,0,20.4283,72.8397
DAMAN & DIU,2001,Car (Government),0,0,0,20.4283,72.8397
DAMAN & DIU,2001,Car (Private),0,0,0,20.4283,72.8397
DAMAN & DIU,2001,Three Wheeler,1,0,1,20.4283,72.8397
DAMAN & DIU,2001,Two Wheeler,1,0,1,20.4283,72.8397
DAMAN & DIU,2001,Bicycle,3,0,3,20.4283,72.8397
DAMAN & DIU,2001,Pedestrian,2,0,2,20.4283,72.8397
DAMAN & DIU,2001,Others (Please Specify),1,0,1,20.4283,72.8397
DAMAN & DIU,2002,Truck/Lorry (Government),0,0,0,20.4283,72.8397
DAMAN & DIU,2002,Truck/Lorry (Private),0,0,0,20.4283,72.8397
DAMAN & DIU,2002,Bus (Government),0,0,0,20.4283,72.8397
DAMAN & DIU,2002,Bus (Private),0,0,0,20.4283,72.8397
DAMAN & DIU,2002,Tempo/Vans (Government),0,0,0,20.4283,72.8397
DAMAN & DIU,2002,Tempo/Vans (Private),0,0,0,20.4283,72.8397
DAMAN & DIU,2002,Jeep (Government),0,0,0,20.4283,72.8397
DAMAN & DIU,2002,Jeep (Private),0,0,0,20.4283,72.8397
DAMAN & DIU,2002,Car (Government),0,1,1,20.4283,72.8397
DAMAN & DIU,2002,Car (Private),0,0,0,20.4283,72.8397
DAMAN & DIU,2002,Three Wheeler,0,0,0,20.4283,72.8397
DAMAN & DIU,2002,Two Wheeler,11,1,12,20.4283,72.8397
DAMAN & DIU,2002,Bicycle,1,0,1,20.4283,72.8397
DAMAN & DIU,2002,Pedestrian,4,0,4,20.4283,72.8397
DAMAN & DIU,2002,Others (Please Specify),0,0,0,20.4283,72.8397
DAMAN & DIU,2003,Truck/Lorry (Government),0,0,0,20.4283,72.8397
DAMAN & DIU,2003,Truck/Lorry (Private),0,0,0,20.4283,72.8397
DAMAN & DIU,2003,Bus (Government),0,0,0,20.4283,72.8397
DAMAN & DIU,2003,Bus (Private),0,0,0,20.4283,72.8397
DAMAN & DIU,2003,Tempo/Vans (Government),0,0,0,20.4283,72.8397
DAMAN & DIU,2003,Tempo/Vans (Private),0,0,0,20.4283,72.8397
DAMAN & DIU,2003,Jeep (Government),1,0,1,20.4283,72.8397
DAMAN & DIU,2003,Jeep (Private),0,0,0,20.4283,72.8397
DAMAN & DIU,2003,Car (Government),0,0,0,20.4283,72.8397
DAMAN & DIU,2003,Car (Private),0,0,0,20.4283,72.8397
DAMAN & DIU,2003,Three Wheeler,0,1,1,20.4283,72.8397
DAMAN & DIU,2003,Two Wheeler,6,1,7,20.4283,72.8397
DAMAN & DIU,2003,Bicycle,4,0,4,20.4283,72.8397
DAMAN & DIU,2003,Pedestrian,4,2,6,20.4283,72.8397
DAMAN & DIU,2003,Others (Please Specify),0,0,0,20.4283,72.8397
DAMAN & DIU,2004,Truck/Lorry (Government),0,0,0,20.4283,72.8397
DAMAN & DIU,2004,Truck/Lorry (Private),6,0,6,20.4283,72.8397
DAMAN & DIU,2004,Bus (Government),0,0,0,20.4283,72.8397
DAMAN & DIU,2004,Bus (Private),0,0,0,20.4283,72.8397
DAMAN & DIU,2004,Tempo/Vans (Government),0,0,0,20.4283,72.8397
DAMAN & DIU,2004,Tempo/Vans (Private),3,0,3,20.4283,72.8397
DAMAN & DIU,2004,Jeep (Government),0,0,0,20.4283,72.8397
DAMAN & DIU,2004,Jeep (Private),0,0,0,20.4283,72.8397
DAMAN & DIU,2004,Car (Government),0,0,0,20.4283,72.8397
DAMAN & DIU,2004,Car (Private),3,0,3,20.4283,72.8397
DAMAN & DIU,2004,Three Wheeler,2,1,3,20.4283,72.8397
DAMAN & DIU,2004,Two Wheeler,6,0,6,20.4283,72.8397
DAMAN & DIU,2004,Bicycle,0,0,0,20.4283,72.8397
DAMAN & DIU,2004,Pedestrian,0,1,1,20.4283,72.8397
DAMAN & DIU,2004,Others (Please Specify),2,0,2,20.4283,72.8397
DAMAN & DIU,2005,Truck/Lorry (Government),0,0,0,20.4283,72.8397
DAMAN & DIU,2005,Truck/Lorry (Private),2,0,2,20.4283,72.8397
DAMAN & DIU,2005,Bus (Government),0,0,0,20.4283,72.8397
DAMAN & DIU,2005,Bus (Private),0,0,0,20.4283,72.8397
DAMAN & DIU,2005,Tempo/Vans (Government),0,0,0,20.4283,72.8397
DAMAN & DIU,2005,Tempo/Vans (Private),2,0,2,20.4283,72.8397
DAMAN & DIU,2005,Jeep (Government),0,0,0,20.4283,72.8397
DAMAN & DIU,2005,Jeep (Private),0,0,0,20.4283,72.8397
DAMAN & DIU,2005,Car (Government),0,0,0,20.4283,72.8397
DAMAN & DIU,2005,Car (Private),5,0,5,20.4283,72.8397
DAMAN & DIU,2005,Three Wheeler,0,0,0,20.4283,72.8397
DAMAN & DIU,2005,Two Wheeler,10,1,11,20.4283,72.8397
DAMAN & DIU,2005,Bicycle,0,0,0,20.4283,72.8397
DAMAN & DIU,2005,Pedestrian,1,1,2,20.4283,72.8397
DAMAN & DIU,2005,Others (Please Specify),2,0,2,20.4283,72.8397
DAMAN & DIU,2006,Truck/Lorry (Government),0,0,0,20.4283,72.8397
DAMAN & DIU,2006,Truck/Lorry (Private),0,0,0,20.4283,72.8397
DAMAN & DIU,2006,Bus (Government),0,0,0,20.4283,72.8397
DAMAN & DIU,2006,Bus (Private),1,0,1,20.4283,72.8397
DAMAN & DIU,2006,Tempo/Vans (Government),0,0,0,20.4283,72.8397
DAMAN & DIU,2006,Tempo/Vans (Private),0,0,0,20.4283,72.8397
DAMAN & DIU,2006,Jeep (Government),0,0,0,20.4283,72.8397
DAMAN & DIU,2006,Jeep (Private),0,0,0,20.4283,72.8397
DAMAN & DIU,2006,Car (Government),0,0,0,20.4283,72.8397
DAMAN & DIU,2006,Car (Private),0,0,0,20.4283,72.8397
DAMAN & DIU,2006,Three Wheeler,2,0,2,20.4283,72.8397
DAMAN & DIU,2006,Two Wheeler,12,0,12,20.4283,72.8397
DAMAN & DIU,2006,Bicycle,5,0,5,20.4283,72.8397
DAMAN & DIU,2006,Pedestrian,6,0,6,20.4283,72.8397
DAMAN & DIU,2006,Others (Please Specify),0,1,1,20.4283,72.8397
DAMAN & DIU,2007,Truck/Lorry (Government),0,0,0,20.4283,72.8397
DAMAN & DIU,2007,Truck/Lorry (Private),0,0,0,20.4283,72.8397
DAMAN & DIU,2007,Bus (Government),0,0,0,20.4283,72.8397
DAMAN & DIU,2007,Bus (Private),1,0,1,20.4283,72.8397
DAMAN & DIU,2007,Tempo/Vans (Government),0,0,0,20.4283,72.8397
DAMAN & DIU,2007,Tempo/Vans (Private),0,0,0,20.4283,72.8397
DAMAN & DIU,2007,Jeep (Government),0,0,0,20.4283,72.8397
DAMAN & DIU,2007,Jeep (Private),0,0,0,20.4283,72.8397
DAMAN & DIU,2007,Car (Government),0,0,0,20.4283,72.8397
DAMAN & DIU,2007,Car (Private),1,0,1,20.4283,72.8397
DAMAN & DIU,2007,Three Wheeler,1,1,2,20.4283,72.8397
DAMAN & DIU,2007,Two Wheeler,14,0,14,20.4283,72.8397
DAMAN & DIU,2007,Bicycle,1,0,1,20.4283,72.8397
DAMAN & DIU,2007,Pedestrian,7,2,9,20.4283,72.8397
DAMAN & DIU,2007,Others (Please Specify),1,0,1,20.4283,72.8397
DAMAN & DIU,2008,Truck/Lorry (Government),0,0,0,20.4283,72.8397
DAMAN & DIU,2008,Truck/Lorry (Private),0,0,0,20.4283,72.8397
DAMAN & DIU,2008,Bus (Government),0,0,0,20.4283,72.8397
DAMAN & DIU,2008,Bus (Private),0,0,0,20.4283,72.8397
DAMAN & DIU,2008,Tempo/Vans (Government),0,0,0,20.4283,72.8397
DAMAN & DIU,2008,Tempo/Vans (Private),0,0,0,20.4283,72.8397
DAMAN & DIU,2008,Jeep (Government),0,0,0,20.4283,72.8397
DAMAN & DIU,2008,Jeep (Private),0,0,0,20.4283,72.8397
DAMAN & DIU,2008,Car (Government),0,0,0,20.4283,72.8397
DAMAN & DIU,2008,Car (Private),2,0,2,20.4283,72.8397
DAMAN & DIU,2008,Three Wheeler,2,0,2,20.4283,72.8397
DAMAN & DIU,2008,Two Wheeler,8,0,8,20.4283,72.8397
DAMAN & DIU,2008,Bicycle,6,0,6,20.4283,72.8397
DAMAN & DIU,2008,Pedestrian,0,0,0,20.4283,72.8397
DAMAN & DIU,2008,Others (Please Specify),3,0,3,20.4283,72.8397
DAMAN & DIU,2009,Truck/Lorry (Government),0,0,0,20.4283,72.8397
DAMAN & DIU,2009,Truck/Lorry (Private),0,0,0,20.4283,72.8397
DAMAN & DIU,2009,Bus (Government),0,0,0,20.4283,72.8397
DAMAN & DIU,2009,Bus (Private),0,0,0,20.4283,72.8397
DAMAN & DIU,2009,Tempo/Vans (Government),0,0,0,20.4283,72.8397
DAMAN & DIU,2009,Tempo/Vans (Private),0,0,0,20.4283,72.8397
DAMAN & DIU,2009,Jeep (Government),0,0,0,20.4283,72.8397
DAMAN & DIU,2009,Jeep (Private),0,0,0,20.4283,72.8397
DAMAN & DIU,2009,Car (Government),1,0,1,20.4283,72.8397
DAMAN & DIU,2009,Car (Private),1,0,1,20.4283,72.8397
DAMAN & DIU,2009,Three Wheeler,0,0,0,20.4283,72.8397
DAMAN & DIU,2009,Two Wheeler,11,0,11,20.4283,72.8397
DAMAN & DIU,2009,Bicycle,0,0,0,20.4283,72.8397
DAMAN & DIU,2009,Pedestrian,0,0,0,20.4283,72.8397
DAMAN & DIU,2009,Others (Please Specify),0,0,0,20.4283,72.8397
DAMAN & DIU,2010,Truck/Lorry (Government),1,0,1,20.4283,72.8397
DAMAN & DIU,2010,Truck/Lorry (Private),0,0,0,20.4283,72.8397
DAMAN & DIU,2010,Bus (Government),0,0,0,20.4283,72.8397
DAMAN & DIU,2010,Bus (Private),0,0,0,20.4283,72.8397
DAMAN & DIU,2010,Tempo/Vans (Government),0,0,0,20.4283,72.8397
DAMAN & DIU,2010,Tempo/Vans (Private),0,0,0,20.4283,72.8397
DAMAN & DIU,2010,Jeep (Government),0,0,0,20.4283,72.8397
DAMAN & DIU,2010,Jeep (Private),0,0,0,20.4283,72.8397
DAMAN & DIU,2010,Car (Government),0,0,0,20.4283,72.8397
DAMAN & DIU,2010,Car (Private),0,0,0,20.4283,72.8397
DAMAN & DIU,2010,Three Wheeler,5,0,5,20.4283,72.8397
DAMAN & DIU,2010,Two Wheeler,9,2,11,20.4283,72.8397
DAMAN & DIU,2010,Bicycle,3,0,3,20.4283,72.8397
DAMAN & DIU,2010,Pedestrian,3,0,3,20.4283,72.8397
DAMAN & DIU,2010,Others (Please Specify),0,0,0,20.4283,72.8397
DAMAN & DIU,2011,Truck/Lorry (Government),0,0,0,20.4283,72.8397
DAMAN & DIU,2011,Truck/Lorry (Private),3,0,3,20.4283,72.8397
DAMAN & DIU,2011,Bus (Government),0,0,0,20.4283,72.8397
DAMAN & DIU,2011,Bus (Private),2,0,2,20.4283,72.8397
DAMAN & DIU,2011,Tempo/Vans (Government),1,0,1,20.4283,72.8397
DAMAN & DIU,2011,Tempo/Vans (Private),1,0,1,20.4283,72.8397
DAMAN & DIU,2011,Jeep (Government),1,0,1,20.4283,72.8397
DAMAN & DIU,2011,Jeep (Private),1,0,1,20.4283,72.8397
DAMAN & DIU,2011,Car (Government),1,0,1,20.4283,72.8397
DAMAN & DIU,2011,Car (Private),1,0,1,20.4283,72.8397
DAMAN & DIU,2011,Three Wheeler,1,0,1,20.4283,72.8397
DAMAN & DIU,2011,Two Wheeler,1,0,1,20.4283,72.8397
DAMAN & DIU,2011,Bicycle,0,0,0,20.4283,72.8397
DAMAN & DIU,2011,Pedestrian,4,1,5,20.4283,72.8397
DAMAN & DIU,2011,Others (Please Specify),3,0,3,20.4283,72.8397
DAMAN & DIU,2012,Truck/Lorry (Government),0,0,0,20.4283,72.8397
DAMAN & DIU,2012,Truck/Lorry (Private),0,0,0,20.4283,72.8397
DAMAN & DIU,2012,Bus (Government),0,0,0,20.4283,72.8397
DAMAN & DIU,2012,Bus (Private),1,0,1,20.4283,72.8397
DAMAN & DIU,2012,Tempo/Vans (Government),0,0,0,20.4283,72.8397
DAMAN & DIU,2012,Tempo/Vans (Private),0,0,0,20.4283,72.8397
DAMAN & DIU,2012,Jeep (Government),0,0,0,20.4283,72.8397
DAMAN & DIU,2012,Jeep (Private),0,0,0,20.4283,72.8397
DAMAN & DIU,2012,Car (Government),0,0,0,20.4283,72.8397
DAMAN & DIU,2012,Car (Private),3,0,3,20.4283,72.8397
DAMAN & DIU,2012,Three Wheeler,0,0,0,20.4283,72.8397
DAMAN & DIU,2012,Two Wheeler,15,1,16,20.4283,72.8397
DAMAN & DIU,2012,Bicycle,1,0,1,20.4283,72.8397
DAMAN & DIU,2012,Pedestrian,7,0,7,20.4283,72.8397
DAMAN & DIU,2012,Others (Please Specify),1,0,1,20.4283,72.8397
Delhi,2001,Truck/Lorry (Government),13,2,15,28.6699929,77.23000403
Delhi,2001,Truck/Lorry (Private),120,17,137,28.6699929,77.23000403
Delhi,2001,Bus (Government),34,10,44,28.6699929,77.23000403
Delhi,2001,Bus (Private),154,31,185,28.6699929,77.23000403
Delhi,2001,Tempo/Vans (Government),5,1,6,28.6699929,77.23000403
Delhi,2001,Tempo/Vans (Private),90,16,106,28.6699929,77.23000403
Delhi,2001,Jeep (Government),0,0,0,28.6699929,77.23000403
Delhi,2001,Jeep (Private),12,1,13,28.6699929,77.23000403
Delhi,2001,Car (Government),1,0,1,28.6699929,77.23000403
Delhi,2001,Car (Private),101,16,117,28.6699929,77.23000403
Delhi,2001,Three Wheeler,57,7,64,28.6699929,77.23000403
Delhi,2001,Two Wheeler,312,42,354,28.6699929,77.23000403
Delhi,2001,Bicycle,142,5,147,28.6699929,77.23000403
Delhi,2001,Pedestrian,490,67,557,28.6699929,77.23000403
Delhi,2001,Others (Please Specify),135,19,154,28.6699929,77.23000403
Delhi,2002,Truck/Lorry (Government),8,0,8,28.6699929,77.23000403
Delhi,2002,Truck/Lorry (Private),92,7,99,28.6699929,77.23000403
Delhi,2002,Bus (Government),17,4,21,28.6699929,77.23000403
Delhi,2002,Bus (Private),96,20,116,28.6699929,77.23000403
Delhi,2002,Tempo/Vans (Government),2,0,2,28.6699929,77.23000403
Delhi,2002,Tempo/Vans (Private),73,18,91,28.6699929,77.23000403
Delhi,2002,Jeep (Government),2,1,3,28.6699929,77.23000403
Delhi,2002,Jeep (Private),15,2,17,28.6699929,77.23000403
Delhi,2002,Car (Government),2,0,2,28.6699929,77.23000403
Delhi,2002,Car (Private),85,17,102,28.6699929,77.23000403
Delhi,2002,Three Wheeler,68,7,75,28.6699929,77.23000403
Delhi,2002,Two Wheeler,366,34,400,28.6699929,77.23000403
Delhi,2002,Bicycle,147,6,153,28.6699929,77.23000403
Delhi,2002,Pedestrian,524,71,595,28.6699929,77.23000403
Delhi,2002,Others (Please Specify),79,5,84,28.6699929,77.23000403
Delhi,2003,Truck/Lorry (Government),16,2,18,28.6699929,77.23000403
Delhi,2003,Truck/Lorry (Private),108,14,122,28.6699929,77.23000403
Delhi,2003,Bus (Government),20,2,22,28.6699929,77.23000403
Delhi,2003,Bus (Private),141,22,163,28.6699929,77.23000403
Delhi,2003,Tempo/Vans (Government),3,0,3,28.6699929,77.23000403
Delhi,2003,Tempo/Vans (Private),91,16,107,28.6699929,77.23000403
Delhi,2003,Jeep (Government),1,0,1,28.6699929,77.23000403
Delhi,2003,Jeep (Private),17,0,17,28.6699929,77.23000403
Delhi,2003,Car (Government),1,0,1,28.6699929,77.23000403
Delhi,2003,Car (Private),85,21,106,28.6699929,77.23000403
Delhi,2003,Three Wheeler,50,2,52,28.6699929,77.23000403
Delhi,2003,Two Wheeler,365,37,402,28.6699929,77.23000403
Delhi,2003,Bicycle,154,12,166,28.6699929,77.23000403
Delhi,2003,Pedestrian,434,56,490,28.6699929,77.23000403
Delhi,2003,Others (Please Specify),225,21,246,28.6699929,77.23000403
Delhi,2004,Truck/Lorry (Government),4,1,5,28.6699929,77.23000403
Delhi,2004,Truck/Lorry (Private),124,14,138,28.6699929,77.23000403
Delhi,2004,Bus (Government),26,2,28,28.6699929,77.23000403
Delhi,2004,Bus (Private),123,26,149,28.6699929,77.23000403
Delhi,2004,Tempo/Vans (Government),1,0,1,28.6699929,77.23000403
Delhi,2004,Tempo/Vans (Private),87,1,88,28.6699929,77.23000403
Delhi,2004,Jeep (Government),2,0,2,28.6699929,77.23000403
Delhi,2004,Jeep (Private),19,3,22,28.6699929,77.23000403
Delhi,2004,Car (Government),10,1,11,28.6699929,77.23000403
Delhi,2004,Car (Private),107,13,120,28.6699929,77.23000403
Delhi,2004,Three Wheeler,86,7,93,28.6699929,77.23000403
Delhi,2004,Two Wheeler,338,35,373,28.6699929,77.23000403
Delhi,2004,Bicycle,132,3,135,28.6699929,77.23000403
Delhi,2004,Pedestrian,547,92,639,28.6699929,77.23000403
Delhi,2004,Others (Please Specify),140,17,157,28.6699929,77.23000403
Delhi,2005,Truck/Lorry (Government),2,3,5,28.6699929,77.23000403
Delhi,2005,Truck/Lorry (Private),132,10,142,28.6699929,77.23000403
Delhi,2005,Bus (Government),34,6,40,28.6699929,77.23000403
Delhi,2005,Bus (Private),109,24,133,28.6699929,77.23000403
Delhi,2005,Tempo/Vans (Government),7,1,8,28.6699929,77.23000403
Delhi,2005,Tempo/Vans (Private),77,9,86,28.6699929,77.23000403
Delhi,2005,Jeep (Government),0,0,0,28.6699929,77.23000403
Delhi,2005,Jeep (Private),12,4,16,28.6699929,77.23000403
Delhi,2005,Car (Government),0,0,0,28.6699929,77.23000403
Delhi,2005,Car (Private),107,16,123,28.6699929,77.23000403
Delhi,2005,Three Wheeler,71,13,84,28.6699929,77.23000403
Delhi,2005,Two Wheeler,435,36,471,28.6699929,77.23000403
Delhi,2005,Bicycle,116,4,120,28.6699929,77.23000403
Delhi,2005,Pedestrian,407,78,485,28.6699929,77.23000403
Delhi,2005,Others (Please Specify),292,18,310,28.6699929,77.23000403
Delhi,2006,Truck/Lorry (Government),6,1,7,28.6699929,77.23000403
Delhi,2006,Truck/Lorry (Private),123,8,131,28.6699929,77.23000403
Delhi,2006,Bus (Government),35,1,36,28.6699929,77.23000403
Delhi,2006,Bus (Private),111,15,126,28.6699929,77.23000403
Delhi,2006,Tempo/Vans (Government),0,0,0,28.6699929,77.23000403
Delhi,2006,Tempo/Vans (Private),92,13,105,28.6699929,77.23000403
Delhi,2006,Jeep (Government),2,0,2,28.6699929,77.23000403
Delhi,2006,Jeep (Private),19,3,22,28.6699929,77.23000403
Delhi,2006,Car (Government),0,0,0,28.6699929,77.23000403
Delhi,2006,Car (Private),129,25,154,28.6699929,77.23000403
Delhi,2006,Three Wheeler,68,8,76,28.6699929,77.23000403
Delhi,2006,Two Wheeler,491,34,525,28.6699929,77.23000403
Delhi,2006,Bicycle,91,1,92,28.6699929,77.23000403
Delhi,2006,Pedestrian,618,74,692,28.6699929,77.23000403
Delhi,2006,Others (Please Specify),185,14,199,28.6699929,77.23000403
Delhi,2007,Truck/Lorry (Government),2,1,3,28.6699929,77.23000403
Delhi,2007,Truck/Lorry (Private),118,9,127,28.6699929,77.23000403
Delhi,2007,Bus (Government),33,4,37,28.6699929,77.23000403
Delhi,2007,Bus (Private),117,16,133,28.6699929,77.23000403
Delhi,2007,Tempo/Vans (Government),3,1,4,28.6699929,77.23000403
Delhi,2007,Tempo/Vans (Private),84,7,91,28.6699929,77.23000403
Delhi,2007,Jeep (Government),3,1,4,28.6699929,77.23000403
Delhi,2007,Jeep (Private),14,2,16,28.6699929,77.23000403
Delhi,2007,Car (Government),4,1,5,28.6699929,77.23000403
Delhi,2007,Car (Private),140,32,172,28.6699929,77.23000403
Delhi,2007,Three Wheeler,63,8,71,28.6699929,77.23000403
Delhi,2007,Two Wheeler,489,44,533,28.6699929,77.23000403
Delhi,2007,Bicycle,106,2,108,28.6699929,77.23000403
Delhi,2007,Pedestrian,504,59,563,28.6699929,77.23000403
Delhi,2007,Others (Please Specify),241,14,255,28.6699929,77.23000403
Delhi,2008,Truck/Lorry (Government),3,0,3,28.6699929,77.23000403
Delhi,2008,Truck/Lorry (Private),157,13,170,28.6699929,77.23000403
Delhi,2008,Bus (Government),16,7,23,28.6699929,77.23000403
Delhi,2008,Bus (Private),94,16,110,28.6699929,77.23000403
Delhi,2008,Tempo/Vans (Government),1,0,1,28.6699929,77.23000403
Delhi,2008,Tempo/Vans (Private),102,7,109,28.6699929,77.23000403
Delhi,2008,Jeep (Government),0,0,0,28.6699929,77.23000403
Delhi,2008,Jeep (Private),8,2,10,28.6699929,77.23000403
Delhi,2008,Car (Government),1,2,3,28.6699929,77.23000403
Delhi,2008,Car (Private),124,24,148,28.6699929,77.23000403
Delhi,2008,Three Wheeler,74,5,79,28.6699929,77.23000403
Delhi,2008,Two Wheeler,507,47,554,28.6699929,77.23000403
Delhi,2008,Bicycle,68,1,69,28.6699929,77.23000403
Delhi,2008,Pedestrian,517,72,589,28.6699929,77.23000403
Delhi,2008,Others (Please Specify),212,18,230,28.6699929,77.23000403
Delhi,2009,Truck/Lorry (Government),9,1,10,28.6699929,77.23000403
Delhi,2009,Truck/Lorry (Private),108,13,121,28.6699929,77.23000403
Delhi,2009,Bus (Government),19,5,24,28.6699929,77.23000403
Delhi,2009,Bus (Private),47,10,57,28.6699929,77.23000403
Delhi,2009,Tempo/Vans (Government),2,0,2,28.6699929,77.23000403
Delhi,2009,Tempo/Vans (Private),62,10,72,28.6699929,77.23000403
Delhi,2009,Jeep (Government),0,0,0,28.6699929,77.23000403
Delhi,2009,Jeep (Private),14,1,15,28.6699929,77.23000403
Delhi,2009,Car (Government),1,1,2,28.6699929,77.23000403
Delhi,2009,Car (Private),121,17,138,28.6699929,77.23000403
Delhi,2009,Three Wheeler,55,5,60,28.6699929,77.23000403
Delhi,2009,Two Wheeler,662,51,713,28.6699929,77.23000403
Delhi,2009,Bicycle,140,6,146,28.6699929,77.23000403
Delhi,2009,Pedestrian,442,58,500,28.6699929,77.23000403
Delhi,2009,Others (Please Specify),158,9,167,28.6699929,77.23000403
Delhi,2010,Truck/Lorry (Government),3,1,4,28.6699929,77.23000403
Delhi,2010,Truck/Lorry (Private),131,14,145,28.6699929,77.23000403
Delhi,2010,Bus (Government),20,5,25,28.6699929,77.23000403
Delhi,2010,Bus (Private),66,7,73,28.6699929,77.23000403
Delhi,2010,Tempo/Vans (Government),3,0,3,28.6699929,77.23000403
Delhi,2010,Tempo/Vans (Private),85,8,93,28.6699929,77.23000403
Delhi,2010,Jeep (Government),2,0,2,28.6699929,77.23000403
Delhi,2010,Jeep (Private),16,1,17,28.6699929,77.23000403
Delhi,2010,Car (Government),1,3,4,28.6699929,77.23000403
Delhi,2010,Car (Private),193,21,214,28.6699929,77.23000403
Delhi,2010,Three Wheeler,77,10,87,28.6699929,77.23000403
Delhi,2010,Two Wheeler,611,53,664,28.6699929,77.23000403
Delhi,2010,Bicycle,95,10,105,28.6699929,77.23000403
Delhi,2010,Pedestrian,481,53,534,28.6699929,77.23000403
Delhi,2010,Others (Please Specify),180,20,200,28.6699929,77.23000403
Delhi,2011,Truck/Lorry (Government),9,2,11,28.6699929,77.23000403
Delhi,2011,Truck/Lorry (Private),117,13,130,28.6699929,77.23000403
Delhi,2011,Bus (Government),37,11,48,28.6699929,77.23000403
Delhi,2011,Bus (Private),37,7,44,28.6699929,77.23000403
Delhi,2011,Tempo/Vans (Government),3,0,3,28.6699929,77.23000403
Delhi,2011,Tempo/Vans (Private),79,7,86,28.6699929,77.23000403
Delhi,2011,Jeep (Government),0,0,0,28.6699929,77.23000403
Delhi,2011,Jeep (Private),17,2,19,28.6699929,77.23000403
Delhi,2011,Car (Government),1,0,1,28.6699929,77.23000403
Delhi,2011,Car (Private),161,24,185,28.6699929,77.23000403
Delhi,2011,Three Wheeler,58,6,64,28.6699929,77.23000403
Delhi,2011,Two Wheeler,583,59,642,28.6699929,77.23000403
Delhi,2011,Bicycle,76,0,76,28.6699929,77.23000403
Delhi,2011,Pedestrian,517,86,603,28.6699929,77.23000403
Delhi,2011,Others (Please Specify),184,11,195,28.6699929,77.23000403
Delhi,2012,Truck/Lorry (Government),2,0,2,28.6699929,77.23000403
Delhi,2012,Truck/Lorry (Private),112,17,129,28.6699929,77.23000403
Delhi,2012,Bus (Government),24,7,31,28.6699929,77.23000403
Delhi,2012,Bus (Private),29,5,34,28.6699929,77.23000403
Delhi,2012,Tempo/Vans (Government),1,0,1,28.6699929,77.23000403
Delhi,2012,Tempo/Vans (Private),89,9,98,28.6699929,77.23000403
Delhi,2012,Jeep (Government),1,0,1,28.6699929,77.23000403
Delhi,2012,Jeep (Private),11,0,11,28.6699929,77.23000403
Delhi,2012,Car (Government),4,1,5,28.6699929,77.23000403
Delhi,2012,Car (Private),187,13,200,28.6699929,77.23000403
Delhi,2012,Three Wheeler,58,9,67,28.6699929,77.23000403
Delhi,2012,Two Wheeler,453,36,489,28.6699929,77.23000403
Delhi,2012,Bicycle,77,1,78,28.6699929,77.23000403
Delhi,2012,Pedestrian,449,52,501,28.6699929,77.23000403
Delhi,2012,Others (Please Specify),201,18,219,28.6699929,77.23000403
LAKSHADWEEP,2001,Truck/Lorry (Government),0,0,0,10.56257331,72.63686717
LAKSHADWEEP,2001,Truck/Lorry (Private),0,0,0,10.56257331,72.63686717
LAKSHADWEEP,2001,Bus (Government),0,0,0,10.56257331,72.63686717
LAKSHADWEEP,2001,Bus (Private),0,0,0,10.56257331,72.63686717
LAKSHADWEEP,2001,Tempo/Vans (Government),0,0,0,10.56257331,72.63686717
LAKSHADWEEP,2001,Tempo/Vans (Private),0,0,0,10.56257331,72.63686717
LAKSHADWEEP,2001,Jeep (Government),0,0,0,10.56257331,72.63686717
LAKSHADWEEP,2001,Jeep (Private),0,0,0,10.56257331,72.63686717
LAKSHADWEEP,2001,Car (Government),0,0,0,10.56257331,72.63686717
LAKSHADWEEP,2001,Car (Private),0,0,0,10.56257331,72.63686717
LAKSHADWEEP,2001,Three Wheeler,0,0,0,10.56257331,72.63686717
LAKSHADWEEP,2001,Two Wheeler,1,0,1,10.56257331,72.63686717
LAKSHADWEEP,2001,Bicycle,0,0,0,10.56257331,72.63686717
LAKSHADWEEP,2001,Pedestrian,0,0,0,10.56257331,72.63686717
LAKSHADWEEP,2001,Others (Please Specify),0,0,0,10.56257331,72.63686717
LAKSHADWEEP,2002,Truck/Lorry (Government),0,0,0,10.56257331,72.63686717
LAKSHADWEEP,2002,Truck/Lorry (Private),0,0,0,10.56257331,72.63686717
LAKSHADWEEP,2002,Bus (Government),0,0,0,10.56257331,72.63686717
LAKSHADWEEP,2002,Bus (Private),0,0,0,10.56257331,72.63686717
LAKSHADWEEP,2002,Tempo/Vans (Government),0,0,0,10.56257331,72.63686717
LAKSHADWEEP,2002,Tempo/Vans (Private),0,0,0,10.56257331,72.63686717
LAKSHADWEEP,2002,Jeep (Government),0,0,0,10.56257331,72.63686717
LAKSHADWEEP,2002,Jeep (Private),0,0,0,10.56257331,72.63686717
LAKSHADWEEP,2002,Car (Government),0,0,0,10.56257331,72.63686717
LAKSHADWEEP,2002,Car (Private),0,0,0,10.56257331,72.63686717
LAKSHADWEEP,2002,Three Wheeler,0,0,0,10.56257331,72.63686717
LAKSHADWEEP,2002,Two Wheeler,0,0,0,10.56257331,72.63686717
LAKSHADWEEP,2002,Bicycle,0,0,0,10.56257331,72.63686717
LAKSHADWEEP,2002,Pedestrian,0,0,0,10.56257331,72.63686717
LAKSHADWEEP,2002,Others (Please Specify),0,0,0,10.56257331,72.63686717
LAKSHADWEEP,2003,Truck/Lorry (Government),0,0,0,10.56257331,72.63686717
LAKSHADWEEP,2003,Truck/Lorry (Private),0,0,0,10.56257331,72.63686717
LAKSHADWEEP,2003,Bus (Government),0,0,0,10.56257331,72.63686717
LAKSHADWEEP,2003,Bus (Private),0,0,0,10.56257331,72.63686717
LAKSHADWEEP,2003,Tempo/Vans (Government),0,0,0,10.56257331,72.63686717
LAKSHADWEEP,2003,Tempo/Vans (Private),0,0,0,10.56257331,72.63686717
LAKSHADWEEP,2003,Jeep (Government),0,0,0,10.56257331,72.63686717
LAKSHADWEEP,2003,Jeep (Private),0,0,0,10.56257331,72.63686717
LAKSHADWEEP,2003,Car (Government),0,0,0,10.56257331,72.63686717
LAKSHADWEEP,2003,Car (Private),0,0,0,10.56257331,72.63686717
LAKSHADWEEP,2003,Three Wheeler,0,0,0,10.56257331,72.63686717
LAKSHADWEEP,2003,Two Wheeler,1,0,1,10.56257331,72.63686717
LAKSHADWEEP,2003,Bicycle,0,0,0,10.56257331,72.63686717
LAKSHADWEEP,2003,Pedestrian,0,0,0,10.56257331,72.63686717
LAKSHADWEEP,2003,Others (Please Specify),0,0,0,10.56257331,72.63686717
LAKSHADWEEP,2004,Truck/Lorry (Government),0,0,0,10.56257331,72.63686717
LAKSHADWEEP,2004,Truck/Lorry (Private),0,0,0,10.56257331,72.63686717
LAKSHADWEEP,2004,Bus (Government),0,0,0,10.56257331,72.63686717
LAKSHADWEEP,2004,Bus (Private),0,0,0,10.56257331,72.63686717
LAKSHADWEEP,2004,Tempo/Vans (Government),0,0,0,10.56257331,72.63686717
LAKSHADWEEP,2004,Tempo/Vans (Private),0,0,0,10.56257331,72.63686717
LAKSHADWEEP,2004,Jeep (Government),0,0,0,10.56257331,72.63686717
LAKSHADWEEP,2004,Jeep (Private),0,0,0,10.56257331,72.63686717
LAKSHADWEEP,2004,Car (Government),0,0,0,10.56257331,72.63686717
LAKSHADWEEP,2004,Car (Private),0,0,0,10.56257331,72.63686717
LAKSHADWEEP,2004,Three Wheeler,0,0,0,10.56257331,72.63686717
LAKSHADWEEP,2004,Two Wheeler,0,0,0,10.56257331,72.63686717
LAKSHADWEEP,2004,Bicycle,0,0,0,10.56257331,72.63686717
LAKSHADWEEP,2004,Pedestrian,0,0,0,10.56257331,72.63686717
LAKSHADWEEP,2004,Others (Please Specify),0,0,0,10.56257331,72.63686717
LAKSHADWEEP,2005,Truck/Lorry (Government),0,0,0,10.56257331,72.63686717
LAKSHADWEEP,2005,Truck/Lorry (Private),0,0,0,10.56257331,72.63686717
LAKSHADWEEP,2005,Bus (Government),0,0,0,10.56257331,72.63686717
LAKSHADWEEP,2005,Bus (Private),0,0,0,10.56257331,72.63686717
LAKSHADWEEP,2005,Tempo/Vans (Government),0,0,0,10.56257331,72.63686717
LAKSHADWEEP,2005,Tempo/Vans (Private),0,0,0,10.56257331,72.63686717
LAKSHADWEEP,2005,Jeep (Government),0,0,0,10.56257331,72.63686717
LAKSHADWEEP,2005,Jeep (Private),0,0,0,10.56257331,72.63686717
LAKSHADWEEP,2005,Car (Government),0,0,0,10.56257331,72.63686717
LAKSHADWEEP,2005,Car (Private),0,0,0,10.56257331,72.63686717
LAKSHADWEEP,2005,Three Wheeler,0,0,0,10.56257331,72.63686717
LAKSHADWEEP,2005,Two Wheeler,0,0,0,10.56257331,72.63686717
LAKSHADWEEP,2005,Bicycle,0,0,0,10.56257331,72.63686717
LAKSHADWEEP,2005,Pedestrian,0,0,0,10.56257331,72.63686717
LAKSHADWEEP,2005,Others (Please Specify),0,0,0,10.56257331,72.63686717
LAKSHADWEEP,2006,Truck/Lorry (Government),0,0,0,10.56257331,72.63686717
LAKSHADWEEP,2006,Truck/Lorry (Private),0,0,0,10.56257331,72.63686717
LAKSHADWEEP,2006,Bus (Government),0,0,0,10.56257331,72.63686717
LAKSHADWEEP,2006,Bus (Private),0,0,0,10.56257331,72.63686717
LAKSHADWEEP,2006,Tempo/Vans (Government),0,0,0,10.56257331,72.63686717
LAKSHADWEEP,2006,Tempo/Vans (Private),0,0,0,10.56257331,72.63686717
LAKSHADWEEP,2006,Jeep (Government),0,0,0,10.56257331,72.63686717
LAKSHADWEEP,2006,Jeep (Private),0,0,0,10.56257331,72.63686717
LAKSHADWEEP,2006,Car (Government),0,0,0,10.56257331,72.63686717
LAKSHADWEEP,2006,Car (Private),0,0,0,10.56257331,72.63686717
LAKSHADWEEP,2006,Three Wheeler,0,0,0,10.56257331,72.63686717
LAKSHADWEEP,2006,Two Wheeler,1,0,1,10.56257331,72.63686717
LAKSHADWEEP,2006,Bicycle,0,0,0,10.56257331,72.63686717
LAKSHADWEEP,2006,Pedestrian,0,0,0,10.56257331,72.63686717
LAKSHADWEEP,2006,Others (Please Specify),0,0,0,10.56257331,72.63686717
LAKSHADWEEP,2007,Truck/Lorry (Government),0,0,0,10.56257331,72.63686717
LAKSHADWEEP,2007,Truck/Lorry (Private),0,0,0,10.56257331,72.63686717
LAKSHADWEEP,2007,Bus (Government),0,0,0,10.56257331,72.63686717
LAKSHADWEEP,2007,Bus (Private),0,0,0,10.56257331,72.63686717
LAKSHADWEEP,2007,Tempo/Vans (Government),0,0,0,10.56257331,72.63686717
LAKSHADWEEP,2007,Tempo/Vans (Private),0,0,0,10.56257331,72.63686717
LAKSHADWEEP,2007,Jeep (Government),0,0,0,10.56257331,72.63686717
LAKSHADWEEP,2007,Jeep (Private),0,0,0,10.56257331,72.63686717
LAKSHADWEEP,2007,Car (Government),0,0,0,10.56257331,72.63686717
LAKSHADWEEP,2007,Car (Private),0,0,0,10.56257331,72.63686717
LAKSHADWEEP,2007,Three Wheeler,0,0,0,10.56257331,72.63686717
LAKSHADWEEP,2007,Two Wheeler,0,0,0,10.56257331,72.63686717
LAKSHADWEEP,2007,Bicycle,0,0,0,10.56257331,72.63686717
LAKSHADWEEP,2007,Pedestrian,0,0,0,10.56257331,72.63686717
LAKSHADWEEP,2007,Others (Please Specify),0,0,0,10.56257331,72.63686717
LAKSHADWEEP,2008,Truck/Lorry (Government),0,0,0,10.56257331,72.63686717
LAKSHADWEEP,2008,Truck/Lorry (Private),0,0,0,10.56257331,72.63686717
LAKSHADWEEP,2008,Bus (Government),0,0,0,10.56257331,72.63686717
LAKSHADWEEP,2008,Bus (Private),0,0,0,10.56257331,72.63686717
LAKSHADWEEP,2008,Tempo/Vans (Government),0,0,0,10.56257331,72.63686717
LAKSHADWEEP,2008,Tempo/Vans (Private),0,0,0,10.56257331,72.63686717
LAKSHADWEEP,2008,Jeep (Government),0,0,0,10.56257331,72.63686717
LAKSHADWEEP,2008,Jeep (Private),0,0,0,10.56257331,72.63686717
LAKSHADWEEP,2008,Car (Government),0,0,0,10.56257331,72.63686717
LAKSHADWEEP,2008,Car (Private),0,0,0,10.56257331,72.63686717
LAKSHADWEEP,2008,Three Wheeler,0,0,0,10.56257331,72.63686717
LAKSHADWEEP,2008,Two Wheeler,0,0,0,10.56257331,72.63686717
LAKSHADWEEP,2008,Bicycle,0,0,0,10.56257331,72.63686717
LAKSHADWEEP,2008,Pedestrian,0,0,0,10.56257331,72.63686717
LAKSHADWEEP,2008,Others (Please Specify),0,0,0,10.56257331,72.63686717
LAKSHADWEEP,2009,Truck/Lorry (Government),0,0,0,10.56257331,72.63686717
LAKSHADWEEP,2009,Truck/Lorry (Private),0,0,0,10.56257331,72.63686717
LAKSHADWEEP,2009,Bus (Government),0,0,0,10.56257331,72.63686717
LAKSHADWEEP,2009,Bus (Private),0,0,0,10.56257331,72.63686717
LAKSHADWEEP,2009,Tempo/Vans (Government),0,0,0,10.56257331,72.63686717
LAKSHADWEEP,2009,Tempo/Vans (Private),0,0,0,10.56257331,72.63686717
LAKSHADWEEP,2009,Jeep (Government),0,0,0,10.56257331,72.63686717
LAKSHADWEEP,2009,Jeep (Private),0,0,0,10.56257331,72.63686717
LAKSHADWEEP,2009,Car (Government),0,0,0,10.56257331,72.63686717
LAKSHADWEEP,2009,Car (Private),0,0,0,10.56257331,72.63686717
LAKSHADWEEP,2009,Three Wheeler,0,0,0,10.56257331,72.63686717
LAKSHADWEEP,2009,Two Wheeler,2,0,2,10.56257331,72.63686717
LAKSHADWEEP,2009,Bicycle,0,0,0,10.56257331,72.63686717
LAKSHADWEEP,2009,Pedestrian,0,0,0,10.56257331,72.63686717
LAKSHADWEEP,2009,Others (Please Specify),0,0,0,10.56257331,72.63686717
LAKSHADWEEP,2010,Truck/Lorry (Government),0,0,0,10.56257331,72.63686717
LAKSHADWEEP,2010,Truck/Lorry (Private),0,0,0,10.56257331,72.63686717
LAKSHADWEEP,2010,Bus (Government),0,0,0,10.56257331,72.63686717
LAKSHADWEEP,2010,Bus (Private),0,0,0,10.56257331,72.63686717
LAKSHADWEEP,2010,Tempo/Vans (Government),0,0,0,10.56257331,72.63686717
LAKSHADWEEP,2010,Tempo/Vans (Private),0,0,0,10.56257331,72.63686717
LAKSHADWEEP,2010,Jeep (Government),0,0,0,10.56257331,72.63686717
LAKSHADWEEP,2010,Jeep (Private),0,0,0,10.56257331,72.63686717
LAKSHADWEEP,2010,Car (Government),0,0,0,10.56257331,72.63686717
LAKSHADWEEP,2010,Car (Private),0,0,0,10.56257331,72.63686717
LAKSHADWEEP,2010,Three Wheeler,0,0,0,10.56257331,72.63686717
LAKSHADWEEP,2010,Two Wheeler,0,0,0,10.56257331,72.63686717
LAKSHADWEEP,2010,Bicycle,0,0,0,10.56257331,72.63686717
LAKSHADWEEP,2010,Pedestrian,0,0,0,10.56257331,72.63686717
LAKSHADWEEP,2010,Others (Please Specify),0,0,0,10.56257331,72.63686717
LAKSHADWEEP,2011,Truck/Lorry (Government),0,0,0,10.56257331,72.63686717
LAKSHADWEEP,2011,Truck/Lorry (Private),0,0,0,10.56257331,72.63686717
LAKSHADWEEP,2011,Bus (Government),0,0,0,10.56257331,72.63686717
LAKSHADWEEP,2011,Bus (Private),0,0,0,10.56257331,72.63686717
LAKSHADWEEP,2011,Tempo/Vans (Government),0,0,0,10.56257331,72.63686717
LAKSHADWEEP,2011,Tempo/Vans (Private),0,0,0,10.56257331,72.63686717
LAKSHADWEEP,2011,Jeep (Government),0,0,0,10.56257331,72.63686717
LAKSHADWEEP,2011,Jeep (Private),0,0,0,10.56257331,72.63686717
LAKSHADWEEP,2011,Car (Government),0,0,0,10.56257331,72.63686717
LAKSHADWEEP,2011,Car (Private),0,0,0,10.56257331,72.63686717
LAKSHADWEEP,2011,Three Wheeler,0,0,0,10.56257331,72.63686717
LAKSHADWEEP,2011,Two Wheeler,0,0,0,10.56257331,72.63686717
LAKSHADWEEP,2011,Bicycle,0,0,0,10.56257331,72.63686717
LAKSHADWEEP,2011,Pedestrian,0,0,0,10.56257331,72.63686717
LAKSHADWEEP,2011,Others (Please Specify),0,0,0,10.56257331,72.63686717
LAKSHADWEEP,2012,Truck/Lorry (Government),0,0,0,10.56257331,72.63686717
LAKSHADWEEP,2012,Truck/Lorry (Private),0,0,0,10.56257331,72.63686717
LAKSHADWEEP,2012,Bus (Government),0,0,0,10.56257331,72.63686717
LAKSHADWEEP,2012,Bus (Private),0,0,0,10.56257331,72.63686717
LAKSHADWEEP,2012,Tempo/Vans (Government),0,0,0,10.56257331,72.63686717
LAKSHADWEEP,2012,Tempo/Vans (Private),0,0,0,10.56257331,72.63686717
LAKSHADWEEP,2012,Jeep (Government),0,0,0,10.56257331,72.63686717
LAKSHADWEEP,2012,Jeep (Private),0,0,0,10.56257331,72.63686717
LAKSHADWEEP,2012,Car (Government),0,0,0,10.56257331,72.63686717
LAKSHADWEEP,2012,Car (Private),0,0,0,10.56257331,72.63686717
LAKSHADWEEP,2012,Three Wheeler,0,0,0,10.56257331,72.63686717
LAKSHADWEEP,2012,Two Wheeler,0,0,0,10.56257331,72.63686717
LAKSHADWEEP,2012,Bicycle,0,0,0,10.56257331,72.63686717
LAKSHADWEEP,2012,Pedestrian,0,0,0,10.56257331,72.63686717
LAKSHADWEEP,2012,Others (Please Specify),0,0,0,10.56257331,72.63686717
PUDUCHERRY,2001,Truck/Lorry (Government),0,0,0,11.93499371,79.83000037
PUDUCHERRY,2001,Truck/Lorry (Private),6,0,6,11.93499371,79.83000037
PUDUCHERRY,2001,Bus (Government),0,0,0,11.93499371,79.83000037
PUDUCHERRY,2001,Bus (Private),7,1,8,11.93499371,79.83000037
PUDUCHERRY,2001,Tempo/Vans (Government),0,0,0,11.93499371,79.83000037
PUDUCHERRY,2001,Tempo/Vans (Private),0,0,0,11.93499371,79.83000037
PUDUCHERRY,2001,Jeep (Government),0,0,0,11.93499371,79.83000037
PUDUCHERRY,2001,Jeep (Private),0,0,0,11.93499371,79.83000037
PUDUCHERRY,2001,Car (Government),0,0,0,11.93499371,79.83000037
PUDUCHERRY,2001,Car (Private),2,0,2,11.93499371,79.83000037
PUDUCHERRY,2001,Three Wheeler,3,0,3,11.93499371,79.83000037
PUDUCHERRY,2001,Two Wheeler,37,10,47,11.93499371,79.83000037
PUDUCHERRY,2001,Bicycle,39,3,42,11.93499371,79.83000037
PUDUCHERRY,2001,Pedestrian,44,16,60,11.93499371,79.83000037
PUDUCHERRY,2001,Others (Please Specify),1,1,2,11.93499371,79.83000037
PUDUCHERRY,2002,Truck/Lorry (Government),2,0,2,11.93499371,79.83000037
PUDUCHERRY,2002,Truck/Lorry (Private),0,0,0,11.93499371,79.83000037
PUDUCHERRY,2002,Bus (Government),2,0,2,11.93499371,79.83000037
PUDUCHERRY,2002,Bus (Private),7,2,9,11.93499371,79.83000037
PUDUCHERRY,2002,Tempo/Vans (Government),0,0,0,11.93499371,79.83000037
PUDUCHERRY,2002,Tempo/Vans (Private),1,0,1,11.93499371,79.83000037
PUDUCHERRY,2002,Jeep (Government),0,0,0,11.93499371,79.83000037
PUDUCHERRY,2002,Jeep (Private),1,0,1,11.93499371,79.83000037
PUDUCHERRY,2002,Car (Government),0,0,0,11.93499371,79.83000037
PUDUCHERRY,2002,Car (Private),1,1,2,11.93499371,79.83000037
PUDUCHERRY,2002,Three Wheeler,1,2,3,11.93499371,79.83000037
PUDUCHERRY,2002,Two Wheeler,51,5,56,11.93499371,79.83000037
PUDUCHERRY,2002,Bicycle,38,5,43,11.93499371,79.83000037
PUDUCHERRY,2002,Pedestrian,59,11,70,11.93499371,79.83000037
PUDUCHERRY,2002,Others (Please Specify),2,1,3,11.93499371,79.83000037
PUDUCHERRY,2003,Truck/Lorry (Government),0,0,0,11.93499371,79.83000037
PUDUCHERRY,2003,Truck/Lorry (Private),8,0,8,11.93499371,79.83000037
PUDUCHERRY,2003,Bus (Government),1,0,1,11.93499371,79.83000037
PUDUCHERRY,2003,Bus (Private),2,0,2,11.93499371,79.83000037
PUDUCHERRY,2003,Tempo/Vans (Government),0,0,0,11.93499371,79.83000037
PUDUCHERRY,2003,Tempo/Vans (Private),1,0,1,11.93499371,79.83000037
PUDUCHERRY,2003,Jeep (Government),0,0,0,11.93499371,79.83000037
PUDUCHERRY,2003,Jeep (Private),0,0,0,11.93499371,79.83000037
PUDUCHERRY,2003,Car (Government),0,0,0,11.93499371,79.83000037
PUDUCHERRY,2003,Car (Private),1,0,1,11.93499371,79.83000037
PUDUCHERRY,2003,Three Wheeler,1,1,2,11.93499371,79.83000037
PUDUCHERRY,2003,Two Wheeler,64,8,72,11.93499371,79.83000037
PUDUCHERRY,2003,Bicycle,25,4,29,11.93499371,79.83000037
PUDUCHERRY,2003,Pedestrian,57,12,69,11.93499371,79.83000037
PUDUCHERRY,2003,Others (Please Specify),3,0,3,11.93499371,79.83000037
PUDUCHERRY,2004,Truck/Lorry (Government),2,0,2,11.93499371,79.83000037
PUDUCHERRY,2004,Truck/Lorry (Private),48,11,59,11.93499371,79.83000037
PUDUCHERRY,2004,Bus (Government),8,1,9,11.93499371,79.83000037
PUDUCHERRY,2004,Bus (Private),23,3,26,11.93499371,79.83000037
PUDUCHERRY,2004,Tempo/Vans (Government),1,0,1,11.93499371,79.83000037
PUDUCHERRY,2004,Tempo/Vans (Private),9,2,11,11.93499371,79.83000037
PUDUCHERRY,2004,Jeep (Government),0,0,0,11.93499371,79.83000037
PUDUCHERRY,2004,Jeep (Private),3,1,4,11.93499371,79.83000037
PUDUCHERRY,2004,Car (Government),0,0,0,11.93499371,79.83000037
PUDUCHERRY,2004,Car (Private),11,2,13,11.93499371,79.83000037
PUDUCHERRY,2004,Three Wheeler,6,1,7,11.93499371,79.83000037
PUDUCHERRY,2004,Two Wheeler,36,6,42,11.93499371,79.83000037
PUDUCHERRY,2004,Bicycle,0,0,0,11.93499371,79.83000037
PUDUCHERRY,2004,Pedestrian,0,0,0,11.93499371,79.83000037
PUDUCHERRY,2004,Others (Please Specify),6,0,6,11.93499371,79.83000037
PUDUCHERRY,2005,Truck/Lorry (Government),0,0,0,11.93499371,79.83000037
PUDUCHERRY,2005,Truck/Lorry (Private),52,7,59,11.93499371,79.83000037
PUDUCHERRY,2005,Bus (Government),13,1,14,11.93499371,79.83000037
PUDUCHERRY,2005,Bus (Private),22,6,28,11.93499371,79.83000037
PUDUCHERRY,2005,Tempo/Vans (Government),2,0,2,11.93499371,79.83000037
PUDUCHERRY,2005,Tempo/Vans (Private),9,1,10,11.93499371,79.83000037
PUDUCHERRY,2005,Jeep (Government),1,0,1,11.93499371,79.83000037
PUDUCHERRY,2005,Jeep (Private),1,0,1,11.93499371,79.83000037
PUDUCHERRY,2005,Car (Government),0,0,0,11.93499371,79.83000037
PUDUCHERRY,2005,Car (Private),14,4,18,11.93499371,79.83000037
PUDUCHERRY,2005,Three Wheeler,11,4,15,11.93499371,79.83000037
PUDUCHERRY,2005,Two Wheeler,50,15,65,11.93499371,79.83000037
PUDUCHERRY,2005,Bicycle,0,0,0,11.93499371,79.83000037
PUDUCHERRY,2005,Pedestrian,0,0,0,11.93499371,79.83000037
PUDUCHERRY,2005,Others (Please Specify),13,0,13,11.93499371,79.83000037
PUDUCHERRY,2006,Truck/Lorry (Government),0,0,0,11.93499371,79.83000037
PUDUCHERRY,2006,Truck/Lorry (Private),44,10,54,11.93499371,79.83000037
PUDUCHERRY,2006,Bus (Government),14,1,15,11.93499371,79.83000037
PUDUCHERRY,2006,Bus (Private),28,5,33,11.93499371,79.83000037
PUDUCHERRY,2006,Tempo/Vans (Government),0,0,0,11.93499371,79.83000037
PUDUCHERRY,2006,Tempo/Vans (Private),9,0,9,11.93499371,79.83000037
PUDUCHERRY,2006,Jeep (Government),0,0,0,11.93499371,79.83000037
PUDUCHERRY,2006,Jeep (Private),1,0,1,11.93499371,79.83000037
PUDUCHERRY,2006,Car (Government),0,0,0,11.93499371,79.83000037
PUDUCHERRY,2006,Car (Private),16,1,17,11.93499371,79.83000037
PUDUCHERRY,2006,Three Wheeler,16,2,18,11.93499371,79.83000037
PUDUCHERRY,2006,Two Wheeler,52,8,60,11.93499371,79.83000037
PUDUCHERRY,2006,Bicycle,0,0,0,11.93499371,79.83000037
PUDUCHERRY,2006,Pedestrian,0,0,0,11.93499371,79.83000037
PUDUCHERRY,2006,Others (Please Specify),9,1,10,11.93499371,79.83000037
PUDUCHERRY,2007,Truck/Lorry (Government),0,0,0,11.93499371,79.83000037
PUDUCHERRY,2007,Truck/Lorry (Private),8,0,8,11.93499371,79.83000037
PUDUCHERRY,2007,Bus (Government),0,0,0,11.93499371,79.83000037
PUDUCHERRY,2007,Bus (Private),15,0,15,11.93499371,79.83000037
PUDUCHERRY,2007,Tempo/Vans (Government),0,0,0,11.93499371,79.83000037
PUDUCHERRY,2007,Tempo/Vans (Private),2,0,2,11.93499371,79.83000037
PUDUCHERRY,2007,Jeep (Government),0,0,0,11.93499371,79.83000037
PUDUCHERRY,2007,Jeep (Private),0,0,0,11.93499371,79.83000037
PUDUCHERRY,2007,Car (Government),0,0,0,11.93499371,79.83000037
PUDUCHERRY,2007,Car (Private),3,4,7,11.93499371,79.83000037
PUDUCHERRY,2007,Three Wheeler,2,0,2,11.93499371,79.83000037
PUDUCHERRY,2007,Two Wheeler,72,8,80,11.93499371,79.83000037
PUDUCHERRY,2007,Bicycle,28,4,32,11.93499371,79.83000037
PUDUCHERRY,2007,Pedestrian,87,21,108,11.93499371,79.83000037
PUDUCHERRY,2007,Others (Please Specify),1,0,1,11.93499371,79.83000037
PUDUCHERRY,2008,Truck/Lorry (Government),0,0,0,11.93499371,79.83000037
PUDUCHERRY,2008,Truck/Lorry (Private),44,2,46,11.93499371,79.83000037
PUDUCHERRY,2008,Bus (Government),11,2,13,11.93499371,79.83000037
PUDUCHERRY,2008,Bus (Private),22,4,26,11.93499371,79.83000037
PUDUCHERRY,2008,Tempo/Vans (Government),0,0,0,11.93499371,79.83000037
PUDUCHERRY,2008,Tempo/Vans (Private),21,3,24,11.93499371,79.83000037
PUDUCHERRY,2008,Jeep (Government),1,0,1,11.93499371,79.83000037
PUDUCHERRY,2008,Jeep (Private),0,0,0,11.93499371,79.83000037
PUDUCHERRY,2008,Car (Government),0,0,0,11.93499371,79.83000037
PUDUCHERRY,2008,Car (Private),18,2,20,11.93499371,79.83000037
PUDUCHERRY,2008,Three Wheeler,1,1,2,11.93499371,79.83000037
PUDUCHERRY,2008,Two Wheeler,60,11,71,11.93499371,79.83000037
PUDUCHERRY,2008,Bicycle,0,0,0,11.93499371,79.83000037
PUDUCHERRY,2008,Pedestrian,0,0,0,11.93499371,79.83000037
PUDUCHERRY,2008,Others (Please Specify),6,3,9,11.93499371,79.83000037
PUDUCHERRY,2009,Truck/Lorry (Government),0,0,0,11.93499371,79.83000037
PUDUCHERRY,2009,Truck/Lorry (Private),29,4,33,11.93499371,79.83000037
PUDUCHERRY,2009,Bus (Government),9,1,10,11.93499371,79.83000037
PUDUCHERRY,2009,Bus (Private),32,4,36,11.93499371,79.83000037
PUDUCHERRY,2009,Tempo/Vans (Government),0,0,0,11.93499371,79.83000037
PUDUCHERRY,2009,Tempo/Vans (Private),22,1,23,11.93499371,79.83000037
PUDUCHERRY,2009,Jeep (Government),0,0,0,11.93499371,79.83000037
PUDUCHERRY,2009,Jeep (Private),0,0,0,11.93499371,79.83000037
PUDUCHERRY,2009,Car (Government),0,0,0,11.93499371,79.83000037
PUDUCHERRY,2009,Car (Private),19,1,20,11.93499371,79.83000037
PUDUCHERRY,2009,Three Wheeler,3,0,3,11.93499371,79.83000037
PUDUCHERRY,2009,Two Wheeler,58,12,70,11.93499371,79.83000037
PUDUCHERRY,2009,Bicycle,1,0,1,11.93499371,79.83000037
PUDUCHERRY,2009,Pedestrian,0,0,0,11.93499371,79.83000037
PUDUCHERRY,2009,Others (Please Specify),21,1,22,11.93499371,79.83000037
PUDUCHERRY,2010,Truck/Lorry (Government),0,0,0,11.93499371,79.83000037
PUDUCHERRY,2010,Truck/Lorry (Private),37,3,40,11.93499371,79.83000037
PUDUCHERRY,2010,Bus (Government),12,2,14,11.93499371,79.83000037
PUDUCHERRY,2010,Bus (Private),24,6,30,11.93499371,79.83000037
PUDUCHERRY,2010,Tempo/Vans (Government),0,0,0,11.93499371,79.83000037
PUDUCHERRY,2010,Tempo/Vans (Private),23,7,30,11.93499371,79.83000037
PUDUCHERRY,2010,Jeep (Government),0,0,0,11.93499371,79.83000037
PUDUCHERRY,2010,Jeep (Private),1,0,1,11.93499371,79.83000037
PUDUCHERRY,2010,Car (Government),0,0,0,11.93499371,79.83000037
PUDUCHERRY,2010,Car (Private),31,3,34,11.93499371,79.83000037
PUDUCHERRY,2010,Three Wheeler,5,1,6,11.93499371,79.83000037
PUDUCHERRY,2010,Two Wheeler,54,9,63,11.93499371,79.83000037
PUDUCHERRY,2010,Bicycle,0,0,0,11.93499371,79.83000037
PUDUCHERRY,2010,Pedestrian,0,0,0,11.93499371,79.83000037
PUDUCHERRY,2010,Others (Please Specify),18,3,21,11.93499371,79.83000037
PUDUCHERRY,2011,Truck/Lorry (Government),0,0,0,11.93499371,79.83000037
PUDUCHERRY,2011,Truck/Lorry (Private),45,5,50,11.93499371,79.83000037
PUDUCHERRY,2011,Bus (Government),5,2,7,11.93499371,79.83000037
PUDUCHERRY,2011,Bus (Private),24,7,31,11.93499371,79.83000037
PUDUCHERRY,2011,Tempo/Vans (Government),1,0,1,11.93499371,79.83000037
PUDUCHERRY,2011,Tempo/Vans (Private),18,1,19,11.93499371,79.83000037
PUDUCHERRY,2011,Jeep (Government),0,0,0,11.93499371,79.83000037
PUDUCHERRY,2011,Jeep (Private),0,0,0,11.93499371,79.83000037
PUDUCHERRY,2011,Car (Government),0,0,0,11.93499371,79.83000037
PUDUCHERRY,2011,Car (Private),21,3,24,11.93499371,79.83000037
PUDUCHERRY,2011,Three Wheeler,2,0,2,11.93499371,79.83000037
PUDUCHERRY,2011,Two Wheeler,54,20,74,11.93499371,79.83000037
PUDUCHERRY,2011,Bicycle,0,0,0,11.93499371,79.83000037
PUDUCHERRY,2011,Pedestrian,0,0,0,11.93499371,79.83000037
PUDUCHERRY,2011,Others (Please Specify),23,2,25,11.93499371,79.83000037
PUDUCHERRY,2012,Truck/Lorry (Government),0,0,0,11.93499371,79.83000037
PUDUCHERRY,2012,Truck/Lorry (Private),41,3,44,11.93499371,79.83000037
PUDUCHERRY,2012,Bus (Government),11,1,12,11.93499371,79.83000037
PUDUCHERRY,2012,Bus (Private),26,4,30,11.93499371,79.83000037
PUDUCHERRY,2012,Tempo/Vans (Government),0,0,0,11.93499371,79.83000037
PUDUCHERRY,2012,Tempo/Vans (Private),24,4,28,11.93499371,79.83000037
PUDUCHERRY,2012,Jeep (Government),0,0,0,11.93499371,79.83000037
PUDUCHERRY,2012,Jeep (Private),0,0,0,11.93499371,79.83000037
PUDUCHERRY,2012,Car (Government),0,0,0,11.93499371,79.83000037
PUDUCHERRY,2012,Car (Private),22,2,24,11.93499371,79.83000037
PUDUCHERRY,2012,Three Wheeler,0,0,0,11.93499371,79.83000037
PUDUCHERRY,2012,Two Wheeler,49,15,64,11.93499371,79.83000037
PUDUCHERRY,2012,Bicycle,0,0,0,11.93499371,79.83000037
PUDUCHERRY,2012,Pedestrian,0,0,0,11.93499371,79.83000037
PUDUCHERRY,2012,Others (Please Specify),22,9,31,11.93499371,79.83000037
,,,,,,,
